僞	偽
兇	凶
啓	啟
嫺	嫻
嬀	媯
峯	峰
幺	么
棱	稜
污	汙
泄	洩
涌	湧
潙	溈
潨	潀
爲	為
牀	床
痹	痺
癡	痴
着	著
睾	睪
砹	砈
竈	灶
糉	粽
纔	才
羣	群
蔿	蒍
衆	眾
裏	裡
覈	核
踊	踴
鈁	鍅
錇	鉳
鍀	鎝
鎄	鑀
鎇	鋂
鎿	錼
鑥	鎦
鮎	鯰
麪	麵
