一个巴掌拍不响	一個巴掌拍不響
一个萝卜一个坑	一個蘿蔔一個坑
一个锅里吃饭的	一個鍋裏吃飯的
一亿一千五百万	一億一千五百萬
一亿七千五百万	一億七千五百萬
一亿三千五百万	一億三千五百萬
一亿两千五百万	一億兩千五百萬
一亿四千四百万	一億四千四百萬
一千一百五十万	一千一百五十萬
一千三百五十万	一千三百五十萬
一千两百四十亿	一千兩百四十億
一千五百五十万	一千五百五十萬
一千六百五十万	一千六百五十萬
一口吸尽西江水	一口吸盡西江水
一块石头掉井里	一塊石頭掉井裏
一失足成千古恨	一失足成千古恨
一头人情两面光	一頭人情兩面光
一将功成万骨枯	一將功成萬骨枯
一年之计在于春	一年之計在於春
一日之计在于晨	一日之計在於晨
一旦无常万事休	一旦無常萬事休
一条跳板上走路	一條跳板上走路
一步一个脚印儿	一步一個腳印兒
一致资源定址器	一致資源定址器
一身作事一身当	一身作事一身當
七大工业国集团	七大工業國集團
万丈高楼平地起	萬丈高樓平地起
万事皆从急中错	萬事皆從急中錯
万绿丛中一点红	萬綠叢中一點紅
万绿丛中红一点	萬綠叢中紅一點
三个和尚没水喝	三個和尚沒水喝
三个女人一个墟	三個女人一個墟
三个女人一台戏	三個女人一臺戲
三亿两千五百万	三億兩千五百萬
三江生态旅游区	三江生態旅遊區
上梁不正下梁歪	上樑不正下樑歪
上海证卷交易所	上海證卷交易所
不到乌江不尽头	不到烏江不盡頭
不干己事不张口	不干己事不張口
不把人看在眼里	不把人看在眼裏
不撞南墙不回头	不撞南牆不回頭
不用本钱的勾当	不用本錢的勾當
不看金面看佛面	不看金面看佛面
业精于勤荒于嬉	業精於勤荒於嬉
两个或两个以上	兩個或兩個以上
两个肩膀扛张嘴	兩個肩膀扛張嘴
中俄尼布楚条约	中俄尼布楚條約
中华文化复兴节	中華文化復興節
中国中央电视台	中國中央電視臺
中国人民志愿军	中國人民志願軍
中国历史博物馆	中國歷史博物館
中国进出口银行	中國進出口銀行
中国餐馆症候群	中國餐館症候羣
中央法规标准法	中央法規標準法
中文标准交换码	中文標準交換碼
丰宁满族自治县	豐寧滿族自治縣
临夏回族自治州	臨夏回族自治州
乌什塔拉回族乡	烏什塔拉回族鄉
乌兹别克共和国	烏茲別克共和國
乌托邦社会主义	烏托邦社會主義
乌拉圭回合谈判	烏拉圭回合談判
乘长风破万里浪	乘長風破萬里浪
书中自有千锺粟	書中自有千鍾粟
于斯納爾斯貝里	于斯納爾斯貝里
于斯纳尔斯贝里	于斯納爾斯貝里
五十二亿五千万	五十二億五千萬
五百姻缘天注定	五百姻緣天註定
亚尔发和奥米加	亞爾發和奧米加
亚洲足球联合会	亞洲足球聯合會
人到中年万事休	人到中年萬事休
人如风后入江云	人如風後入江雲
人心不同如其面	人心不同如其面
人怕出名猪怕壮	人怕出名豬怕壯
人怕出名猪怕肥	人怕出名豬怕肥
人类基因组计划	人類基因組計劃
介质访问控制层	介質訪問控制層
从云端栽了下来	從雲端栽了下來
以十人而制千虎	以十人而制千虎
会计准则理事会	會計準則理事會
伯罗奔尼撒同盟	伯羅奔尼撒同盟
伸手不打笑面人	伸手不打笑面人
佛瑞斯特怀特克	佛瑞斯特懷特克
信息与通讯技术	信息與通訊技術
假期忧郁症候羣	假期憂鬱症候羣
偷得浮生半日闲	偷得浮生半日閒
克罗地亚共和国	克羅地亞共和國
全国不分区代表	全國不分區代表
全彩干式印表机	全彩乾式印表機
八仙桌上摆夜壸	八仙桌上擺夜壺
八位元个人电脑	八位元個人電腦
八十天环游地球	八十天環遊地球
八千里路云和月	八千里路雲和月
公公向孙子磕头	公公向孫子磕頭
公法上职务关系	公法上職務關係
公门之中好修行	公門之中好修行
共产主义青年团	共產主義青年團
农业生产合作社	農業生產合作社
农产品平准基金	農產品平準基金
冠状动脉硬化症	冠狀動脈硬化症
冷灰里爆出火来	冷灰裏爆出火來
几家欢乐几家愁	幾家歡樂幾家愁
出头椽儿先朽烂	出頭椽兒先朽爛
分布式发展模型	分布式發展模型
分布式拒绝服务	分佈式拒絕服務
创伤后压力紊乱	創傷後壓力紊亂
别人的肉偎不热	別人的肉偎不熱
别日南鸿才北去	別日南鴻纔北去
刮风下雪倒便宜	刮風下雪倒便宜
刺激启动不同步	刺激啓動不同步
前词汇语音加工	前詞彙語音加工
加勒比海共同体	加勒比海共同體
加拿大铝业集团	加拿大鋁業集團
劳工退休准备金	勞工退休準備金
化隆回族自治县	化隆回族自治縣
北京中医药大学	北京中醫藥大學
北马里亚纳群岛	北馬裏亞納羣島
十个指头有长短	十個指頭有長短
十个指头朝里弯	十個指頭朝裏彎
十五个吊桶打水	十五個吊桶打水
十谒朱门九不开	十謁朱門九不開
十里长亭无客走	十里長亭無客走
千年田地八百主	千年田地八百主
千里姻缘一线牵	千裏姻緣一綫牽
千里达和多巴哥	千里達和多巴哥
千鸟渊国家公墓	千鳥淵國家公墓
单核细胞增多症	單核細胞增多症
卖了儿子招女婿	賣了兒子招女婿
卖油娘子水梳头	賣油娘子水梳頭
卖盐的做雕銮匠	賣鹽的做雕鑾匠
卖金须向识金家	賣金須向識金家
南枝向火北枝寒	南枝向火北枝寒
历史比较语言学	歷史比較語言學
双语立体声系统	雙語立體聲系統
反酷刑折磨公约	反酷刑折磨公約
发乎情止乎礼义	發乎情止乎禮義
变异型克雅氏症	變異型克雅氏症
只重衣衫不重人	只重衣衫不重人
叮叮当当的婆娘	叮叮噹噹的婆娘
台北市喜愿协会	臺北市喜願協會
台北捷运中和线	臺北捷運中和綫
台北捷运新店线	臺北捷運新店綫
台北捷运木栅线	臺北捷運木柵綫
台北捷运淡水线	臺北捷運淡水綫
台湾世界展望会	臺灣世界展望會
台湾新美术运动	臺灣新美術運動
叱咤叱咤叱咤咤	叱吒叱吒叱吒吒
右分枝关系从句	右分枝關係從句
吃亏就是占便宜	吃虧就是佔便宜
吃葱吃蒜不吃姜	吃蔥吃蒜不吃薑
吉伯特氏症候群	吉伯特氏症候羣
吉里巴斯共和国	吉里巴斯共和國
吊死鬼的裹脚布	吊死鬼的裹腳布
同是天涯沦落人	同是天涯淪落人
同步辐射加速器	同步輻射加速器
后续的解释过程	後續的解釋過程
君子言先不言后	君子言先不言後
听不得一面之词	聽不得一面之詞
吾为之范我驰驱	吾爲之範我馳驅
咬折丁子的老婆	咬折丁子的老婆
哄了一日是两晌	哄了一日是兩晌
哑妇倾杯反受殃	啞婦傾杯反受殃
哪里摔倒哪里爬	哪裏摔倒哪裏爬
噶拉多杰仁波切	噶拉多傑仁波切
四千四百五十万	四千四百五十萬
国家发展改革委	國家發展改革委
国家外汇管理局	國家外匯管理局
国家旅游度假区	國家旅遊度假區
国家计划委员会	國家計劃委員會
国建学术联谊会	國建學術聯誼會
国立历史博物馆	國立歷史博物館
国立台湾博物馆	國立臺灣博物館
国立台湾图书馆	國立臺灣圖書館
国际体操联合会	國際體操聯合會
国际先驱论坛报	國際先驅論壇報
国际标准化组织	國際標準化組織
国际航空联合会	國際航空聯合會
国际足球联合会	國際足球聯合會
地老天荒不了情	地老天荒不了情
培特曼赫鲁威克	培特曼赫魯威克
基本多文种平面	基本多文種平面
基里巴斯共和国	基裏巴斯共和國
塔克拉玛干沙漠	塔克拉瑪干沙漠
塞尔维亚民主党	塞爾維亞民主黨
夏虫不可以语冰	夏蟲不可以語冰
外交关系理事会	外交關係理事會
外屋里的灶君爷	外屋裏的竈君爺
多媒体简报系统	多媒體簡報系統
大丈夫志在四方	大丈夫志在四方
大厂回族自治县	大廠回族自治縣
大山谷州立大学	大山谷州立大學
大水冲倒龙王庙	大水沖倒龍王廟
大水冲倒龙王殿	大水沖倒龍王殿
大脑出血性中风	大腦出血性中風
大角度俯冲轰炸	大角度俯衝轟炸
大象口里拔生牙	大象口裏拔生牙
天冬苯丙二肽酯	天冬苯丙二肽酯
太平洋联合铁路	太平洋聯合鐵路
太阳微系统公司	太陽微系統公司
夫妻无隔宿之仇	夫妻無隔宿之仇
夫妻本是同林鸟	夫妻本是同林鳥
头发胡子一把抓	頭髮鬍子一把抓
奥林匹克体育场	奧林匹克體育場
奥林匹克运动会	奧林匹克運動會
奶妈怀里的孩子	奶媽懷裏的孩子
好了疮口忘了痛	好了瘡口忘了痛
好了疮疤忘了痛	好了瘡疤忘了痛
好汉不怕出身低	好漢不怕出身低
好汉不论出身低	好漢不論出身低
好汉做事好汉当	好漢做事好漢當
好汉只怕病来磨	好漢只怕病來磨
好话当作耳边风	好話當作耳邊風
如入宝山空手回	如入寶山空手回
婴儿猝死症候羣	嬰兒猝死症候羣
婴儿猝死综合症	嬰兒猝死綜合症
子宫內膜异位症	子宮內膜異位症
孟村回族自治县	孟村回族自治縣
宁夏回族自治区	寧夏回族自治區
安地卡及巴布达	安地卡及巴布達
安提瓜和巴布达	安提瓜和巴布達
官不怕大只怕管	官不怕大只怕管
察哈尔右翼后旗	察哈爾右翼後旗
寿险责任准备金	壽險責任準備金
山地管制游览区	山地管制遊覽區
山雨欲来风满楼	山雨欲來風滿樓
岫岩满族自治县	岫巖滿族自治縣
巴尔贝里尼宫殿	巴爾貝里尼宮殿
巴布亚新几内亚	巴布亞新幾內亞
巴布亚纽几內亚	巴布亞紐幾內亞
巴布亚纽几内亚	巴布亞紐幾內亞
巴贝西亚原虫病	巴貝西亞原蟲病
布兰妮斯皮尔斯	布蘭妮斯皮爾斯
布列兹涅夫主义	布列茲涅夫主義
布宜诺斯艾利斯	布宜諾斯艾利斯
布拉马普得拉河	布拉馬普得拉河
布里斯托尔海峡	布里斯托爾海峽
帖撒罗尼迦后书	帖撒羅尼迦後書
干敲梆子不卖油	乾敲梆子不賣油
幸于始者怠于终	幸於始者怠於終
幸福女人小公主	幸福女人小公主
库木吐拉千佛洞	庫木吐拉千佛洞
应收帐款周转率	應收帳款週轉率
开放性医疗制度	開放性醫療制度
异频雷达收发机	異頻雷達收發機
弄了个鱼头来拆	弄了個魚頭來拆
弗里德里希席勒	弗里德里希席勒
当家三年狗也嫌	當家三年狗也嫌
当家才知柴米价	當家纔知柴米價
当家方知柴米贵	當家方知柴米貴
当面银子对面钱	當面銀子對面錢
得放手时须放手	得放手時須放手
德国统一社会党	德國統一社會黨
德意志关税同盟	德意志關稅同盟
心有余而力不足	心有餘而力不足
急水也有回头浪	急水也有回頭浪
恶人自有恶人磨	惡人自有惡人磨
情人眼里出西施	情人眼裏出西施
情人眼里有西施	情人眼裏有西施
戴姆勒克莱斯勒	戴姆勒克萊斯勒
房地产共同基金	房地產共同基金
才可容颜十五余	纔可容顏十五餘
打了个落花流水	打了個落花流水
打墙板儿翻上下	打牆板兒翻上下
打开板壁讲亮话	打開板壁講亮話
打狗不看主人面	打狗不看主人面
打老鼠伤了玉瓶	打老鼠傷了玉瓶
拒人于千里之外	拒人於千里之外
拔了萝卜地皮宽	拔了蘿蔔地皮寬
拨开云雾见青天	撥開雲霧見青天
拨接式数据通信	撥接式數據通信
拿着鸡毛当令箭	拿着雞毛當令箭
挑得篮里便是菜	挑得籃裏便是菜
换算无收获面积	換算無收穫面積
推倒了油瓶不扶	推倒了油瓶不扶
摊薄后每股盈利	攤薄後每股盈利
放一百二十个心	放一百二十個心
放之四海而皆准	放之四海而皆准
放射性发光材料	放射性發光材料
敏于事而慎于言	敏於事而慎於言
敦克尔克大撤退	敦克爾克大撤退
数据调制解调器	數據調制解調器
整合式配线系统	整合式配綫系統
整合管理资讯化	整合管理資訊化
斯洛伐克共和国	斯洛伐克共和國
昌吉回族自治州	昌吉回族自治州
明中舍去暗中来	明中捨去暗中來
春凳折了靠背儿	春凳折了靠背兒
春宵一刻值千金	春宵一刻值千金
是非只为多开口	是非只爲多開口
曼苏尔．达杜拉	曼蘇爾．達杜拉
有仇不报非君子	有仇不報非君子
有宝何必人前夸	有寶何必人前誇
有晚娘就有晚爷	有晚娘就有晚爺
有缘千里来相会	有緣千里來相會
有被种子植物纲	有被種子植物綱
有钱不买半年闲	有錢不買半年閒
木里藏族自治县	木裏藏族自治縣
本杰明富兰克林	本傑明富蘭克林
杭州萝卜绍兴种	杭州蘿蔔紹興種
杯底不可饲金鱼	杯底不可飼金魚
松桃苗族自治县	松桃苗族自治縣
柏克里克千佛洞	柏克里克千佛洞
柳暗花明又一村	柳暗花明又一村
树欲息而风不停	樹欲息而風不停
树欲静而风不止	樹欲靜而風不止
格林威治天文台	格林威治天文臺
梁山伯与祝英台	梁山伯與祝英臺
模里西斯共和国	模里西斯共和國
横眉冷对千夫指	橫眉冷對千夫指
歇洛克福尔摩斯	歇洛克福爾摩斯
正电子发射体层	正電子發射體層
正电子发射层析	正電子發射層析
毒药苦口利于病	毒藥苦口利於病
水流內布袋戏台	水流內布袋戲臺
汉弥登钟表公司	漢彌登鐘錶公司
江南机器制造局	江南機器製造局
汤姆索亚历险记	湯姆索亞歷險記
没个黑家白日的	沒個黑家白日的
没有闲钱补笊篱	沒有閒錢補笊籬
河里孩儿岸上娘	河裏孩兒岸上孃
洋浦经济开发区	洋浦經濟開發區
济州特别自治道	濟州特別自治道
浪子回头金不换	浪子回頭金不換
海湾合作理事会	海灣合作理事會
涡轮喷气发动机	渦輪噴氣發動機
满城尽带黄金甲	滿城盡帶黃金甲
烦恼皆因强出头	煩惱皆因強出頭
焉耆回族自治县	焉耆回族自治縣
然身死才数月耳	然身死纔數月耳
煮熟的鸭子飞了	煮熟的鴨子飛了
爱之适足以害之	愛之適足以害之
牵一发而动全身	牽一髮而動全身
犹太复国主义者	猶太復國主義者
狗嘴里还有象牙	狗嘴裏還有象牙
独立国家联合体	獨立國家聯合體
猪八戒吃人参果	豬八戒吃人參果
猫儿见了鱼鲜饭	貓兒見了魚鮮飯
电缆调制解调器	電纜調制解調器
电脑图书出版业	電腦圖書出版業
白雪公主症候羣	白雪公主症候羣
百万吨级核武器	百萬噸級核武器
皮划艇激流回旋	皮劃艇激流回旋
皮尔斯布洛斯南	皮爾斯布洛斯南
盎格鲁萨克逊人	盎格魯薩克遜人
直销式传销制度	直銷式傳銷制度
眉毛胡子一把抓	眉毛鬍子一把抓
眼泪往肚子里流	眼淚往肚子裏流
眼里揉不下沙子	眼裏揉不下沙子
知人知面不知心	知人知面不知心
矬子里头选将军	矬子裏頭選將軍
石油输出国组织	石油輸出國組織
破蒸笼只会撒气	破蒸籠只會撒氣
破风筝抖起来了	破風箏抖起來了
科学技术现代化	科學技術現代化
科尔沁左翼后旗	科爾沁左翼後旗
科罗拉多大峡谷	科羅拉多大峽谷
秤砣虽小压千斤	秤砣雖小壓千斤
空中交通管制员	空中交通管制員
空气喷气发动机	空氣噴氣發動機
符拉迪沃斯托克	符拉迪沃斯託克
符拉迪沃斯讬克	符拉迪沃斯託克
等效百万吨当量	等效百萬噸當量
索尔兹伯里平原	索爾茲伯里平原
索尔兹伯里石环	索爾茲伯里石環
细雨蒙蒙忆当年	細雨濛濛憶當年
给个棒锤当针认	給個棒錘當針認
综合业务数字网	綜合業務數字網
网路上同步开票	網路上同步開票
罗夏克墨渍测验	羅夏克墨漬測驗
罗密欧与朱丽叶	羅密歐與朱麗葉
罗密欧与茱丽叶	羅密歐與茱麗葉
置之死地而后生	置之死地而後生
羊毛出在羊身上	羊毛出在羊身上
羊肉落在狗嘴里	羊肉落在狗嘴裏
美国总统报复权	美國總統報復權
美国标准交换码	美國標準交換碼
翻手作云复手雨	翻手作雲覆手雨
翻把恩人当仇人	翻把恩人當仇人
老太婆的裹脚布	老太婆的裹腳布
老鸹窝里出凤凰	老鴰窩裏出鳳凰
耳朵里冒出脚来	耳朵裏冒出腳來
联合国粮农组织	聯合國糧農組織
股票投资获利率	股票投資獲利率
肥水不过别人田	肥水不過別人田
肺炎克雷伯氏菌	肺炎克雷伯氏菌
胖姑娘坐小轿儿	胖姑娘坐小轎兒
胜负乃兵家常事	勝負乃兵家常事
胜败乃兵家常事	勝敗乃兵家常事
胜过一个诸葛亮	勝過一個諸葛亮
腰椎间盘突出症	腰椎間盤突出症
航空母舰战斗群	航空母艦戰鬥羣
艾维斯普里斯莱	艾維斯普里斯萊
苏格兰女王玛丽	蘇格蘭女王瑪麗
苏联最高苏维埃	蘇聯最高蘇維埃
苏里安提沙洛索	蘇里安提沙洛索
英雄只怕病来磨	英雄只怕病來磨
茄二十八星瓢虫	茄二十八星瓢蟲
葫芦里卖甚么药	葫蘆裏賣甚麼藥
蒙古人民共和国	蒙古人民共和國
虚拟通道标志符	虛擬通道標誌符
融合式翼梢小翼	融合式翼梢小翼
褶皱山系火地岛	褶皺山系火地島
覆巢之下无完卵	覆巢之下無完卵
见了和尚骂贼秃	見了和尚罵賊禿
见了新人忘旧人	見了新人忘舊人
观光游憩性资源	觀光遊憩性資源
解铃仍须系铃人	解鈴仍須繫鈴人
解铃还是系铃人	解鈴還是繫鈴人
解铃还须系铃人	解鈴還須繫鈴人
计算机集成制造	計算機集成制造
认知神经心里学	認知神經心裏學
识时务者为俊杰	識時務者爲俊傑
诗词曲语辞汇释	詩詞曲語辭匯釋
说嘴郎中无好药	說嘴郎中無好藥
败子回头金不换	敗子回頭金不換
贪婪是万恶之源	貪婪是萬惡之源
资料库管理系统	資料庫管理系統
赔了夫人又折兵	賠了夫人又折兵
跨通道启动技术	跨通道啓動技術
跳出釜底进火坑	跳出釜底進火坑
跳梁猖獗之小丑	跳樑猖獗之小醜
过了这村没这店	過了這村沒這店
过了青春无少年	過了青春無少年
运输设备修护费	運輸設備修護費
近视眼生了瞎子	近視眼生了瞎子
远水救不了近火	遠水救不了近火
连鬼也不见一个	連鬼也不見一個
通用资源识别号	通用資源識別號
逢人只说三分话	逢人只說三分話
道不同不相为谋	道不同不相爲謀
那个猫儿不吃腥	那個貓兒不吃腥
那个耗子不偷油	那個耗子不偷油
鄂温克族自治旗	鄂溫克族自治旗
酒逢知己千锺少	酒逢知己千鍾少
醋娘子要食杨梅	醋娘子要食楊梅
铜盆撞了铁扫帚	銅盆撞了鐵掃帚
银行利害关系人	銀行利害關係人
镰形血球贫血症	鐮形血球貧血症
长坂坡七进七出	長阪坡七進七出
门源回族自治县	門源回族自治縣
门神里边卷灶爷	門神裏邊捲竈爺
防锁死煞车系统	防鎖死煞車系統
阴极射线示波器	陰極射綫示波器
阶级斗争熄灭论	階級鬥爭熄滅論
阿兹海默症病患	阿茲海默症病患
阿加莎克里斯蒂	阿加莎克裏斯蒂
阿尔茨海默氏症	阿爾茨海默氏症
阿拉伯共同市场	阿拉伯共衕市場
陪了夫人又折兵	陪了夫人又折兵
陷之死地而后生	陷之死地而後生
隧道尽头的光亮	隧道盡頭的光亮
雅鲁藏布大峡谷	雅魯藏布大峽谷
雷射血管成形术	雷射血管成形術
需要是发明之母	需要是發明之母
露出了狐狸尾巴	露出了狐狸尾巴
露营休闲车旅游	露營休閒車旅遊
青康滇纵谷高原	青康滇縱谷高原
非同步传输模式	非同步傳輸模式
非游离辐射伤害	非游離輻射傷害
面向对象的技术	面嚮對象的技術
面朝黄土背朝天	面朝黃土背朝天
革命发展阶段论	革命發展階段論
韩国联合通讯社	韓國聯合通訊社
顶梁骨走了真魂	頂梁骨走了真魂
须将有日思无日	須將有日思無日
风吹砂子迷了眼	風吹砂子迷了眼
飞航资料记录器	飛航資料記錄器
食品药品监督局	食品藥品監督局
饱人不知饿人饥	飽人不知餓人飢
饱汉不知饿汉饥	飽漢不知餓漢飢
香格里拉怡咖啡	香格里拉怡咖啡
香港工会联合会	香港工會聯合會
香港贸易发展局	香港貿易發展局
马克思列宁主义	馬克思列寧主義
马蹄刀瓢里切菜	馬蹄刀瓢裏切菜
高丽八万大藏经	高麗八萬大藏經
高速缓冲存储器	高速緩衝存儲器
鲁般手里调大斧	魯般手裏調大斧
麦克罗尼西亚人	麥克羅尼西亞人
麻婆子的裹脚布	麻婆子的裹腳布
龙游浅水遭虾戏	龍游淺水遭蝦戲
龙胜各族自治县	龍勝各族自治縣
