一个不小心	一個不小心
一个心眼儿	一個心眼兒
一个接一个	一個接一個
一价吃到饱	一價吃到飽
一千零一夜	一千零一夜
一去不复返	一去不復返
一夫一妻制	一夫一妻制
一妻多夫制	一妻多夫制
一子继承制	一子繼承制
一对一斗牛	一對一鬥牛
一心挂两头	一心挂兩頭
一手托两家	一手托兩家
一沐三捉发	一沐三捉髮
一沐三握发	一沐三握髮
一物克一物	一物剋一物
一种粗棉布	一種粗棉布
一致性效应	一致性效應
一诺值千金	一諾值千金
一醉解千愁	一醉解千愁
一锹掘个井	一鍬掘個井
一面儿官司	一面兒官司
一鼻孔出气	一鼻孔出氣
丁种维生素	丁種維生素
七姊妹星团	七姊妹星團
万事起头难	萬事起頭難
万国博览会	萬國博覽會
万圣节前夕	萬聖節前夕
万恶淫为首	萬惡淫爲首
万福玛丽亚	萬福瑪麗亞
万般皆下品	萬般皆下品
万里春愁直	萬裏春愁直
三个臭皮匠	三個臭皮匠
三个鼻子管	三個鼻子管
三分钟热度	三分鐘熱度
三合一疫苗	三合一疫苗
三合复元音	三合複元音
三国志平话	三國志平話
三头马车制	三頭馬車制
三对三斗牛	三對三鬥牛
三思而后行	三思而後行
三杯和万事	三杯和萬事
三级三审制	三級三審制
三脚采茶戏	三腳採茶戲
上下五千年	上下五千年
上不了台面	上不了臺面
上不得台盘	上不得臺盤
下水道系统	下水道系統
不为米折腰	不爲米折腰
不以词害志	不以詞害誌
不以辞害志	不以辭害志
不切合实际	不切合實際
不吃烟火食	不吃煙火食
不合作运动	不合作運動
不干涉主义	不干涉主義
不干这把刀	不幹這把刀
不当一回事	不當一回事
不当人化化	不當人化化
不当家化化	不當家化化
不当家花拉	不當家花拉
不当家花花	不當家花花
不当家豁拉	不當家豁拉
不打不成才	不打不成才
不断电系统	不斷電系統
不正当关系	不正當關係
不正当竞争	不正當競爭
不确定故意	不確定故意
不等价交换	不等價交換
不结汇进口	不結匯進口
不能赞一辞	不能贊一辭
丑人多作怪	醜人多作怪
专制君主制	專制君主制
丙种经纪人	丙種經紀人
业余爱好者	業餘愛好者
东加里曼丹	東加里曼丹
东芝医疗系	東芝醫療繫
东非共同体	東非共同體
东非大裂谷	東非大裂谷
两个或更多	兩個或更多
两性化合物	兩性化合物
两极真空管	兩極真空管
两面不是人	兩面不是人
两面不讨好	兩面不討好
个人工作室	個人工作室
个人所得税	個人所得稅
个人秀空间	個人秀空間
个人追逐赛	個人追逐賽
个体手工业	個體手工業
中华电视台	中華電視臺
中华革命党	中華革命黨
中国共产党	中國共產黨
中国同盟会	中國同盟會
中国国民党	中國國民黨
中国地震台	中國地震臺
中国新民党	中國新民黨
中国时报系	中國時報系
中国美术馆	中國美術館
中国致公党	中國致公黨
中型钟表面	中型鐘表面
中央标准局	中央標準局
中央电视台	中央電視臺
临海水土志	臨海水土誌
主题论坛区	主題論壇區
久磁发电机	久磁發電機
久赌无胜家	久賭無勝家
义和团运动	義和團運動
乌兰察布市	烏蘭察布市
乌兹冲锋枪	烏茲衝鋒槍
乌兹别克人	烏茲別克人
乌兹别克族	烏茲別克族
乌孜别克族	烏孜別克族
乌孜别克语	烏孜別克語
乌拉特后旗	烏拉特後旗
乌梁海盆地	烏梁海盆地
乌苏里斯克	烏蘇里斯克
乌里雅苏台	烏里雅蘇臺
乌鲁克恰提	烏魯克恰提
乌鲁克穆河	烏魯克穆河
乔治克隆尼	喬治克隆尼
乔治克鲁尼	喬治克魯尼
乔治．布希	喬治．布希
乙种促效剂	乙種促效劑
乙种国库券	乙種國庫券
乙种维生素	乙種維生素
九九乘法表	九九乘法表
九亿五千万	九億五千萬
九千五百万	九千五百萬
乡民代表会	鄉民代表會
乡镇民代表	鄉鎮民代表
书写不能症	書寫不能症
买咸鱼放生	買鹹魚放生
买风云雷雨	買風雲雷雨
乱哄不过来	亂鬨不過來
乳糖不耐症	乳糖不耐症
乾坤大挪移	乾坤大挪移
事后诸葛亮	事後諸葛亮
二冲程引擎	二衝程引擎
二杆子脾气	二桿子脾氣
二进制编码	二進制編碼
二里头文化	二里頭文化
二重分类表	二重分類表
二项式系数	二項式係數
于奇库杜克	于奇庫杜克
于奇庫杜克	于奇庫杜克
于雾霭之中	於霧靄之中
于韋斯屈萊	于韋斯屈萊
于韦斯屈莱	于韋斯屈萊
云烟过眼录	雲煙過眼錄
云端里老鼠	雲端裏老鼠
云麾将军碑	雲麾將軍碑
五胡十六国	五胡十六國
五花腌猪肉	五花醃豬肉
五谷王北街	五谷王北街
五谷王南街	五谷王南街
亚历塞耶夫	亞歷塞耶夫
亚古亚布尔	亞古亞布爾
亚太经合会	亞太經合會
亚当山德勒	亞當山德勒
亚得里亚海	亞得里亞海
亚穆苏克罗	亞穆蘇克羅
亚美尼亚历	亞美尼亞曆
亚词汇单元	亞詞彙單元
亚里士多德	亞里士多德
亚里斯多德	亞里斯多德
交叉耐药性	交叉耐藥性
人克莱门斯	人克萊門斯
人才代训所	人才代訓所
人无前后眼	人無前後眼
人无千日好	人無千日好
人民联盟党	人民聯盟黨
人民行动党	人民行動黨
人生面不熟	人生面不熟
人畜共患症	人畜共患症
人穷志不穷	人窮志不窮
人面逐高低	人面逐高低
从外表来看	從外表來看
仙女座星系	仙女座星系
代数几何学	代數幾何學
以色列工党	以色列工黨
伊士曼彩色	伊士曼彩色
伊尔库次克	伊爾庫次克
伊尔库茨克	伊爾庫茨克
伊斯兰历史	伊斯蘭歷史
伊斯兰教历	伊斯蘭敎曆
伊斯兰美术	伊斯蘭美術
伊斯坦布尔	伊斯坦布爾
伊洛渊源录	伊洛淵源錄
伊皮米修斯	伊皮米修斯
众曲不容直	眾曲不容直
伯尔发斯特	伯爾發斯特
何杰金氏病	何杰金氏病
佛罗里达州	佛羅里達州
佛面上刮金	佛面上刮金
作倒了行市	作倒了行市
作息时间表	作息時間表
你才子发昏	你纔子發昏
佩斯托瑞斯	佩斯托瑞斯
使用者介面	使用者介面
供销合作社	供銷合作社
依然范特西	依然範特西
俄克拉何马	俄克拉何馬
俄国共产党	俄國共產黨
保安责任制	保安責任制
信用合作社	信用合作社
倒钟摆效应	倒鐘擺效應
倚晴楼七种	倚晴樓七種
借梯子下楼	借梯子下樓
借酒三分醉	借酒三分醉
偏极滤光镜	偏極濾光鏡
偏相关系数	偏相關係數
做准备工作	做準備工作
傅立叶变换	傅立葉變換
儒略改革历	儒略改革曆
元曲四大家	元曲四大家
元素周期表	元素週期表
先发投手羣	先發投手羣
光效应艺术	光效應藝術
光电二极体	光電二極體
光电二极管	光電二極管
光面内质网	光面內質網
克什克腾旗	克什克騰旗
克分子浓度	克分子濃度
克利斯朵夫	克利斯朵夫
克卜勒定律	克卜勒定律
克娄巴特拉	克婁巴特拉
克孜勒苏河	克孜勒蘇河
克孜尔尕哈	克孜爾尕哈
克拉夫丘克	克拉夫丘克
克拉斯金诺	克拉斯金諾
克拉玛依区	克拉瑪依區
克拉玛依市	克拉瑪依市
克沙奇病毒	克沙奇病毒
克罗地亚语	克羅地亞語
克罗埃西亚	克羅埃西亞
克莉丝汀娜	克莉絲汀娜
克莉丝特丝	克莉絲特絲
克莉斯蒂纳	克莉斯蒂納
克莱伦斯宫	克萊倫斯宮
克里丝蒂娃	克里絲蒂娃
克里夫欧文	克里夫歐文
克里奥尔语	克里奧爾語
克里姆林宫	克里姆林宮
克里姆林杯	克里姆林杯
克里斯伊凡	克里斯伊凡
克里斯托弗	克里斯托弗
克里斯蒂安	克里斯蒂安
克里木半岛	克里木半島
克里木战争	克里木戰爭
內分泌系统	內分泌系統
內外向包办	內外向包辦
內布拉斯加	內布拉斯加
全国大会党	全國大會黨
八万大藏经	八萬大藏經
八级工资制	八級工資制
公认会计准	公認會計准
公路个人赛	公路個人賽
兰里老太太	蘭里老太太
共产党宣言	共產黨宣言
共产党政府	共產黨政府
共产党部队	共產黨部隊
共同交际语	共同交際語
共同决议案	共同決議案
共同被告人	共同被告人
共同财产制	共同財產制
共同通讯社	共同通訊社
共轭不尽根	共軛不盡根
共轭双曲线	共軛雙曲綫
共餐青年团	共餐青年團
关弓与我确	關弓與我确
关系代名词	關係代名詞
兼并与收购	兼併與收購
内在几何学	內在幾何學
内塔尼亚胡	內塔尼亞胡
内布拉斯加	內布拉斯加
内蒙古大学	內蒙古大學
农业合作化	農業合作化
农作物品种	農作物品種
农村合作化	農村合作化
冰上曲棍球	冰上曲棍球
冰火不同炉	冰火不同爐
冰炭不同器	冰炭不同器
冰炭不同罏	冰炭不同罏
冷酒儿后犯	冷酒兒後犯
冷锅里爆豆	冷鍋裏爆豆
准噶尔盆地	準噶爾盆地
准噶尔翼龙	準噶爾翼龍
准格尔盆地	準格爾盆地
准葛尔盆地	準葛爾盆地
减压时间表	減壓時間表
几乎不可能	幾乎不可能
几何拓扑学	幾何拓撲學
几內亚比索	幾內亞比索
几內亚比绍	幾內亞比紹
几内亚比绍	幾內亞比紹
凯特布兰琪	凱特布蘭琪
出手见高低	出手見高低
出版前编目	出版前編目
出版社不详	出版社不詳
出版社丛集	出版社叢集
出版社清样	出版社清樣
出版社装祯	出版社裝禎
出生证明书	出生證明書
分别财产制	分別財產制
分子化合物	分子化合物
分布式环境	分佈式環境
分布式结构	分佈式結構
分布式网络	分佈式網絡
分形几何学	分形幾何學
列氏寒暑表	列氏寒暑表
刘阮上天台	劉阮上天臺
创业板上市	創業板上市
创伤后压力	創傷後壓力
利害关系人	利害關係人
利害关系方	利害關係方
别赫捷列夫	別赫捷列夫
到那个时候	到那個時候
刺头泥里陷	刺頭泥裏陷
前词汇加工	前詞彙加工
前词汇阶段	前詞彙階段
剖宫产手术	剖宮產手術
剖腹产手术	剖腹產手術
剩余放射性	剩餘放射性
剩馀价值率	剩餘價值率
剪牡丹喂牛	剪牡丹喂牛
加工出口区	加工出口區
加解密系统	加解密系統
加里宁格勒	加里寧格勒
加里曼丹岛	加裏曼丹島
加里肋亚海	加里肋亞海
努瓦克肖特	努瓦克肖特
劫后英雄传	劫後英雄傳
劳动基准法	勞動基準法
勃德修正案	勃德修正案
包产到户制	包產到戶制
包皮环切术	包皮環切術
匋斋吉金录	匋齋吉金錄
化学战斗部	化學戰斗部
北极星飞弹	北極星飛彈
北马里亚纳	北馬裏亞納
医药气候学	醫藥氣候學
十万八千里	十萬八千里
十三经注疏	十三經注疏
十二指肠虫	十二指腸蟲
十二木表法	十二木表法
十六国春秋	十六國春秋
十天半个月	十天半個月
十字军东征	十字軍東征
十字军远征	十字軍遠征
千万分之一	千萬分之一
千岛湖事件	千島湖事件
千里始足下	千里始足下
千里寄鹅毛	千里寄鵝毛
千里搭长棚	千里搭長棚
千里送鹅毛	千里送鵝毛
半乳糖血症	半乳糖血症
半保留复制	半保留複製
半岛电视台	半島電視臺
半日制学校	半日制學校
华尔滋舞曲	華爾滋舞曲
华氏寒暑表	華氏寒暑表
卓柏卡布拉	卓柏卡布拉
单一合体字	單一合體字
单位切向量	單位切向量
单克隆抗体	單克隆抗體
单叶双曲面	單葉雙曲面
单子叶植物	單子葉植物
单循环赛制	單循環賽制
单板心合板	單板心合板
南极洲半岛	南極洲半島
南极老人星	南極老人星
占主导地位	占主導地位
占有五不验	占有五不驗
卡式录音带	卡式錄音帶
卡式录音机	卡式錄音機
卡拉布里亚	卡拉布里亞
卡拉曼里斯	卡拉曼里斯
卡纳塔克邦	卡納塔克邦
卡萨布兰加	卡薩布蘭加
卡萨布兰卡	卡薩布蘭卡
卢布尔雅那	盧布爾雅那
卢布里雅纳	盧布里雅納
印制电路板	印製電路板
印刷电路板	印刷電路板
印度人民党	印度人民黨
印度国大党	印度國大黨
厄尔布鲁士	厄爾布魯士
厄立特里亚	厄立特里亞
历代名画记	歷代名畫記
历史博物馆	歷史博物館
历史社会学	歷史社會學
历史语言学	歷史語言學
历来最低点	歷來最低點
原子发电厂	原子發電廠
原子能发电	原子能發電
双向讨论区	雙向討論區
双子叶植物	雙子葉植物
双曲抛物面	雙曲拋物面
双曲线正弦	雙曲綫正弦
双湖特别区	雙湖特別區
双画面电视	雙畫面電視
双龙大裂谷	雙龍大裂谷
反右派斗争	反右派鬥爭
反导向飞弹	反導向飛彈
反时钟方向	反時鐘方向
反转录病毒	反轉錄病毒
发为血之本	髮爲血之本
发光二极体	發光二極體
发光二极管	發光二極管
发展不平均	發展不平均
发展中国家	發展中國家
发展核武器	發展核武器
发展的国家	發展的國家
发育生物学	發育生物學
发行备忘录	發行備忘錄
发行红利股	發行紅利股
发音合作人	發音合作人
变不出花样	變不出花樣
口技表演者	口技表演者
古巴共产党	古巴共產黨
古杰拉特邦	古傑拉特邦
古腾堡计划	古騰堡計劃
只占神问卜	只占神問卜
可变化合价	可變化合價
可可托海镇	可可托海鎮
可持续发展	可持續發展
可望取胜者	可望取勝者
台湾光复节	臺灣光復節
台湾共和国	臺灣共和國
台湾关系法	臺灣關係法
台湾叶鼻蝠	臺灣葉鼻蝠
台湾散打王	臺灣散打王
台湾猕猴桃	臺灣獼猴桃
台湾环颈雉	臺灣環頸雉
台湾疗养院	臺灣療養院
台湾省议会	臺灣省議會
台湾神学院	臺灣神學院
台湾高山族	臺灣高山族
叱咤叱叱咤	叱吒叱叱吒
史克里亚宾	史克里亞賓
史坦布律克	史坦布律克
史坦布瑞纳	史坦布瑞納
史坦布莱纳	史坦布萊納
史塔克豪斯	史塔克豪斯
史托腾柏格	史托騰柏格
史瑞波妮克	史瑞波妮克
叶卡捷琳堡	葉卡捷琳堡
叶卡捷琳娜	葉卡捷琳娜
叶绿体基质	葉綠體基質
叶门共和国	葉門共和國
吃了定心丸	吃了定心丸
吃几碗干饭	吃幾碗乾飯
吃饱没事干	吃飽沒事幹
各打五十板	各打五十板
合众国际社	合眾國際社
合四乙尺工	合四乙尺工
合成洗涤剂	合成洗滌劑
合成清洁剂	合成清潔劑
合成类固醇	合成類固醇
合理化作用	合理化作用
吊死鬼搽粉	吊死鬼搽粉
同位素分离	同位素分離
同位素扫描	同位素掃描
同分异构体	同分異構體
同分异构物	同分異構物
同卵双胞胎	同卵雙胞胎
同心圆理论	同心圓理論
同心方胜儿	同心方勝兒
同性恋酒吧	同性戀酒吧
同时语言学	同時語言學
同步加速器	同步加速器
同步辐射仪	同步輻射儀
同盟会宣言	同盟會宣言
同素异形体	同素異形體
同素异性体	同素異性體
同进士出身	同進士出身
同量异位素	同量異位素
名师出高徒	名師出高徒
名臣言行录	名臣言行錄
后冷战时代	後冷戰時代
后印象主义	後印象主義
后广告纪元	後廣告紀元
后期印象派	後期印象派
后浪推前浪	後浪推前浪
后现代主义	後現代主義
后现代剧场	後現代劇場
后级扩大机	後級擴大機
后词汇加工	後詞彙加工
君主专制制	君主專制制
君主立宪制	君主立憲制
吞米桑布札	吞米桑布札
启发性程式	啓發性程式
吹绵介壳虫	吹綿介殼蟲
周口店文化	周口店文化
周围性眩晕	周圍性眩暈
周武王姬发	周武王姬發
周瑜打黄盖	周瑜打黃蓋
和平工作团	和平工作團
咸菜烧豆腐	鹹菜燒豆腐
哈利法克斯	哈利法克斯
哈特谢普苏	哈特謝普蘇
哈玛斯派系	哈瑪斯派系
哈玛斯集团	哈瑪斯集團
哈萨克斯坦	哈薩克斯坦
哈里发帝国	哈里發帝國
哈里逊福特	哈里遜福特
哥林多后书	哥林多後書
哲布尊丹巴	哲布尊丹巴
唐氏综合症	唐氏綜合症
唐王游地府	唐王遊地府
喀喇崑仑山	喀喇崑崙山
喀喇昆仑山	喀喇崑崙山
喀拉昆仑山	喀拉崑崙山
喷墨印表机	噴墨印表機
喷射发动机	噴射發動機
喷射战斗机	噴射戰鬥機
喷气发动机	噴氣發動機
嗜酸乳干菌	嗜酸乳干菌
噪音管制法	噪音管制法
四两拨千斤	四兩撥千斤
四个现代化	四個現代化
四级三审制	四級三審制
回家吃自己	回家吃自己
回教开斋节	回敎開齋節
回教忠孝节	回敎忠孝節
回旋加速器	迴旋加速器
因斯布鲁克	因斯布魯克
国大主席团	國大主席團
国大代表部	國大代表部
国家标准码	國家標準碼
国民党军队	國民黨軍隊
国民裁判制	國民裁判制
国民革命党	國民革命黨
国际单位制	國際單位制
国际合作节	國際合作節
国际标准舞	國際標準舞
图书巡回车	圖書巡迴車
图木舒克市	圖木舒克市
圣克鲁斯岛	聖克魯斯島
圣塔蒙尼加	聖塔蒙尼加
圣帕特里克	聖帕特里克
圣母升天节	聖母升天節
圣神降临周	聖神降臨週
在全国范围	在全國範圍
在坛子胡同	在罈子胡同
在密切注意	在密切注意
地下修文郎	地下修文郎
地无三里平	地無三里平
地热发电厂	地熱發電廠
地质年代表	地質年代表
地面核爆炸	地面核爆炸
坎塔布连海	坎塔布連海
坐山观虎斗	坐山觀虎鬥
块肉馀生录	塊肉餘生錄
型录式广告	型錄式廣告
埋头寻钟表	埋頭尋鐘錶
城市依赖症	城市依賴症
域多利皇后	域多利皇后
培里克利斯	培裏克利斯
培里克里斯	培里克里斯
塔克拉玛干	塔克拉瑪干
塔克拉马干	塔克拉馬干
塔吉克斯坦	塔吉克斯坦
塔波兰尼克	塔波蘭尼克
塔里契亚努	塔里契亞努
塔里木盆地	塔里木盆地
塞尔提克队	塞爾提克隊
塞尔蒂克队	塞爾蒂克隊
塞莉佛维克	塞莉佛維克
塞车症候羣	塞車症候羣
复分解反应	複分解反應
复变函数论	複變函數論
复合蛋白质	複合蛋白質
复合词素词	複合詞素詞
复循环发电	複循環發電
复本位制度	複本位制度
复杂度理论	複雜度理論
复活的军团	復活的軍團
外侧裂周区	外側裂周區
外国旅游者	外國旅遊者
多云偶阵雨	多雲偶陣雨
多原作艺术	多原作藝術
多媒体杂志	多媒體雜誌
多平台环境	多平臺環境
多式综合语	多式綜合語
多粒子系统	多粒子系統
夜雨秋灯录	夜雨秋燈錄
大义觉迷录	大義覺迷錄
大乌苏里岛	大烏蘇里島
大修理基金	大修理基金
大修道院长	大修道院長
大历十才子	大曆十才子
大叶性肺炎	大葉性肺炎
大叶野百合	大葉野百合
大型钟表面	大型鐘表面
大旱望云霓	大旱望雲霓
大清一统志	大清一統志
大肠杆菌羣	大腸桿菌羣
大虫吃小虫	大蟲吃小蟲
大陆冷气团	大陸冷氣團
大陆性气团	大陸性氣團
大麦克指数	大麥克指數
天不从人愿	天不從人願
天发神谶碑	天發神讖碑
天盟誓表现	天盟誓表現
太平洋周边	太平洋週邊
太平洋周邊	太平洋周邊
太空天文台	太空天文臺
太阳电池板	太陽電池板
太阳神计划	太陽神計劃
太阳黑子周	太陽黑子周
夫妻财产制	夫妻財產制
奉辛比克党	奉辛比克黨
契沙比克湾	契沙比克灣
奥克拉荷马	奧克拉荷馬
奥克斯纳德	奧克斯納德
奥克苏斯河	奧克蘇斯河
奥兰多布鲁	奧蘭多布魯
奥妮克西亚	奧妮克西亞
奥尔布赖特	奧爾布賴特
奥杜伐峡谷	奧杜伐峽谷
奥林匹克日	奧林匹克日
女子参政权	女子參政權
女性艺术史	女性藝術史
奴儿干都司	奴兒干都司
妇女联合会	婦女聯合會
妊娠毒血症	妊娠毒血症
姜太公钓鱼	姜太公釣魚
姜是老的辣	薑是老的辣
威克菲尔德	威克菲爾德
威尔生氏症	威爾生氏症
威氏注音法	威氏註音法
媒体狂并潮	媒體狂併潮
字根合体字	字根合體字
字表输入法	字表輸入法
存款准备率	存款準備率
存款准备金	存款准備金
学了个不留	學了個不留
安纳托利亚	安納托利亞
客制化服务	客製化服務
家具木工科	家具木工科
家和万事兴	家和萬事興
容容多后福	容容多後福
富贵如浮云	富貴如浮雲
察合台汗国	察合臺汗國
察布查尔县	察布査爾縣
对偶多面体	對偶多面體
对妻失语症	對妻失語症
对面不见人	對面不見人
射影几何学	射影幾何學
射雕英雄传	射鵰英雄傳
将相本无种	將相本無種
小儿麻痹症	小兒麻痺症
小团体主义	小團體主義
小型钟表面	小型鐘表面
小池百合子	小池百合子
小秀才学堂	小秀才學堂
尤克里里琴	尤克裏裏琴
尤里比底斯	尤里比底斯
尼加拉瀑布	尼加拉瀑布
尼布楚条约	尼布楚條約
尼布甲尼撒	尼布甲尼撒
屁出了掩臀	屁出了掩臀
山中无历日	山中無曆日
山地管制区	山地管制區
山缪杰克森	山繆傑克森
岩仓使节团	岩倉使節團
峻坂困盐驹	峻阪困鹽駒
巡回图书馆	巡迴圖書館
工业民主制	工業民主制
工厂自动化	工廠自動化
工商综合区	工商綜合區
工布江达县	工布江達縣
工欲善其事	工欲善其事
巧克力脆片	巧克力脆片
已开发国家	已開發國家
巴克莱银行	巴克萊銀行
巴尔克嫩德	巴爾克嫩德
巴尔干半岛	巴爾幹半島
巴尔干山脉	巴爾幹山脈
巴尖儿好胜	巴尖兒好勝
巴布延群岛	巴布延羣島
巴斯德菌症	巴斯德菌症
巴斯特纳克	巴斯特納克
巴比特合金	巴比特合金
巴洛克艺术	巴洛克藝術
巴洛克风格	巴洛克風格
巴里坤草原	巴裏坤草原
巴金森氏症	巴金森氏症
市场占有率	市場佔有率
布兰登堡门	布蘭登堡門
布列兹涅夫	布列茲涅夫
布利斯班市	布利斯班市
布加勒斯特	布加勒斯特
布吉纳法索	布吉納法索
布哈林模式	布哈林模式
布基纳法索	布基納法索
布尔什维克	布爾什維克
布尼亚病毒	布尼亞病毒
布干维尔岛	布干維爾島
布拉席耶利	布拉席耶利
布拉柴维尔	布拉柴維爾
布拉格定律	布拉格定律
布来德史崔	布來德史崔
布氏杆菌病	布氏桿菌病
布热津斯基	布熱津斯基
布特拉加亚	布特拉加亞
布班尼斯瓦	布班尼斯瓦
布痕瓦尔德	布痕瓦爾德
布莱德彼特	布萊德彼特
布里兹涅夫	布里茲涅夫
布里姬沃特	布里姬沃特
布里斯托尔	布裏斯托爾
布里斯本市	布里斯本市
布里斯本河	布里斯本河
布里迪雅通	布里迪雅通
布隆吉尔河	布隆吉爾河
布雷顿森林	佈雷頓森林
布鲁斯威利	布魯斯威利
布鲁氏菌病	布魯氏菌病
希伯来历史	希伯來歷史
希格斯机制	希格斯機制
帕台农神庙	帕臺農神廟
帕拉马里博	帕拉馬裏博
帕累托最优	帕累托最優
帕累托法则	帕累托法則
帕金森氏症	帕金森氏症
常用参考书	常用參考書
常绿阔叶林	常綠闊葉林
干吊着下巴	乾吊着下巴
干煸土豆丝	乾煸土豆絲
平行六面体	平行六面體
平面几何学	平面幾何學
幼发拉底河	幼發拉底河
幽门狭窄症	幽門狹窄症
幽闭恐惧症	幽閉恐懼症
广东药学院	廣東藥學院
广场恐怖症	廣場恐怖症
广场恐惧症	廣場恐懼症
庇里牛斯山	庇里牛斯山
庐山真面目	廬山真面目
库苏古尔湖	庫蘇古爾湖
底栖有孔虫	底棲有孔蟲
底格里斯河	底格里斯河
庙里的猪头	廟裏的豬頭
康乃狄克州	康乃狄克州
建教合作班	建敎合作班
开发中国家	開發中國家
开放式系统	開放式系統
开膛手杰克	開膛手傑克
异烟碱醯酸	異菸鹼醯酸
弗洛里斯岛	弗洛裏斯島
弗罗里达州	弗羅裏達州
弗里得里希	弗裏得裏希
弗里德里希	弗里德里希
弗雷德里克	弗雷德裏克
张玄墓志铭	張玄墓誌銘
张良慕赤松	張良慕赤松
弱智赖于涵	弱智賴于涵
弹药补给站	彈藥補給站
强制猥亵罪	強制猥褻罪
当代新儒家	當代新儒家
当衣买酒喝	當衣買酒喝
录取通知书	錄取通知書
形态发生素	形態發生素
彩妆保养化	彩妝保養化
彩色电视机	彩色電視機
徐妃半面妆	徐妃半面妝
徐霞客游记	徐霞客遊記
得克萨斯州	得克薩斯州
微分几何学	微分幾何學
微微的发烫	微微的發燙
微胶囊技术	微膠囊技術
德克萨斯州	德克薩斯州
德意志银行	德意志銀行
德意志革命	德意志革命
德拉克洛瓦	德拉克洛瓦
德拉克罗瓦	德拉克羅瓦
德谟克拉西	德謨克拉西
心凉了半截	心涼了半截
心宽出少年	心寬出少年
心肺复苏术	心肺復甦術
心脏复苏术	心臟復甦術
心脏收缩压	心臟收縮壓
心脏舒张压	心臟舒張壓
心脏节律器	心臟節律器
心里有个谱	心裏有個譜
心里美萝卜	心裏美蘿蔔
怒江大峡谷	怒江大峽谷
恒春野百合	恆春野百合
恩克巴雅尔	恩克巴雅爾
恩培多克勒	恩培多克勒
恩将仇报者	恩將仇報者
恰克图条约	恰克圖條約
恶事传千里	惡事傳千里
恶人先告状	惡人先告狀
恶人有恶报	惡人有惡報
恶性疟原虫	惡性瘧原蟲
恶马恶人骑	惡馬惡人騎
悬挂式滑翔	懸掛式滑翔
悲怆交响曲	悲愴交響曲
意大利直面	意大利直麵
意见调査表	意見調査表
愿意不愿意	願意不願意
慢工出巧匠	慢工出巧匠
慢工出细活	慢工出細活
慢工出细货	慢工出細貨
成骨不全症	成骨不全症
战术核武器	戰術核武器
房室结回路	房室結迴路
房屋修护费	房屋修護費
扁拟谷盗虫	扁擬穀盜蟲
手掌多汗症	手掌多汗症
才能勇敢追	纔能勇敢追
打了个千儿	打了個千兒
打了个盹儿	打了個盹兒
打伙子穿靴	打夥子穿靴
打出头棒子	打出頭棒子
打干淨毬儿	打乾淨毬兒
打开后门说	打開後門說
托斯卡尼尼	托斯卡尼尼
托比麦奎尔	托比麥奎爾
扩音机系统	擴音機系統
扬州画舫录	揚州畫舫錄
抑扬升降性	抑揚昇降性
投影几何学	投影幾何學
投手防御率	投手防禦率
披头四乐团	披頭四樂團
拉克莫诺夫	拉克莫諾夫
拉布拉他河	拉布拉他河
拉布拉多犬	拉布拉多犬
拉德万斯卡	拉德萬斯卡
拉缆子摆渡	拉纜子擺渡
拉贾帕克萨	拉賈帕克薩
拔不出腿来	拔不出腿來
拜占庭帝国	拜占庭帝國
拜占庭文化	拜占庭文化
拿破仑法典	拿破崙法典
持不同政见	持不同政見
挂帅的社会	掛帥的社會
按时间先后	按時間先後
振衣千仞冈	振衣千仞岡
挺起腰板儿	挺起腰板兒
捏了一把汗	捏了一把汗
换汤不换药	換湯不換藥
捷克共和国	捷克共和國
捷克斯拉夫	捷克斯拉夫
捷尔任斯克	捷爾任斯克
提摩太后书	提摩太後書
搓熟的汤团	搓熟的湯團
摄氏寒暑表	攝氏寒暑表
摆线推进器	擺綫推進器
摩托车的士	摩托車的士
摩根费里曼	摩根費里曼
擂鼓交响曲	擂鼓交響曲
操同室之戈	操同室之戈
收录两用机	收錄兩用機
放射性烟羽	放射性煙羽
放流水标准	放流水標準
救人须救彻	救人須救徹
救生艇甲板	救生艇甲板
敦煌千佛洞	敦煌千佛洞
数以百万计	數以百萬計
数据库软件	數據庫軟件
数据链路层	數據鏈路層
斗大的手卷	斗大的手卷
斗大的馒头	斗大的饅頭
斗智不斗力	鬥智不鬥力
斗牛士之歌	鬥牛士之歌
斗酒博凉州	斗酒博涼州
斯克里亚宾	斯克裏亞賓
斯摩棱斯克	斯摩棱斯克
斯洛伐克语	斯洛伐克語
斯瓦希里语	斯瓦希裏語
斯瓦特谷地	斯瓦特谷地
新不伦瑞克	新不倫瑞克
新几內亚岛	新幾內亞島
新剧同志会	新劇同志會
新罕布什尔	新罕布什爾
新艺综合体	新藝綜合體
新闻发布会	新聞發佈會
新闻发言人	新聞發言人
施诺布莉琪	施諾布莉琪
无伴奏合唱	無伴奏合唱
无机化合物	無機化合物
无烟囱工业	無煙囪工業
无线麦克风	無綫麥克風
无能胜明王	無能勝明王
无针不引线	無針不引綫
无针注射器	無針注射器
无面值邮票	無面值郵票
日本共产党	日本共產黨
日本共同社	日本共同社
日本社会党	日本社會黨
日比谷公园	日比谷公園
明夷待访录	明夷待訪錄
明尼苏大学	明尼蘇大學
明尼苏达州	明尼蘇達州
明师出高徒	明師出高徒
春秋大一统	春秋大一統
春秋左氏传	春秋左氏傳
普列谢茨克	普列謝茨克
普勒托利亚	普勒托利亞
普勒斯威克	普勒斯威克
普拉斯尼克	普拉斯尼克
普朗克常数	普朗克常數
普里什蒂纳	普裏什蒂納
普里斯特莱	普里斯特萊
普里斯蒂纳	普里斯蒂納
普里霍吉可	普里霍吉可
晶体三极体	晶體三極體
晶体三极管	晶體三極管
晶体二极体	晶體二極體
晶体二极管	晶體二極管
暂染发慕丝	暫染髮慕絲
暴君焚城录	暴君焚城錄
曼尼托巴省	曼尼托巴省
最后的审判	最後的審判
最后的晚餐	最後的晚餐
月经规则术	月經規則術
有事之无范	有事之無範
有助于记忆	有助於記憶
有发头陀寺	有髮頭陀寺
有子万事足	有子萬事足
有机化合物	有機化合物
有苦说不出	有苦說不出
朝鲜劳动党	朝鮮勞動黨
未开发国家	未開發國家
本期发生额	本期發生額
札什伦布寺	札什倫布寺
术业有专攻	術業有專攻
朱丝栏抄本	朱絲欄抄本
朱理安历史	朱理安歷史
朴茨茅斯队	朴茨茅斯隊
权利请愿书	權利請願書
李卜克內西	李卜克內西
李卜克内西	李卜克內西
李布瑞斯库	李布瑞斯庫
杜布林斯基	杜布林斯基
来回来去地	來回來去地
杨凌示范区	楊淩示範區
杯酒释兵权	杯酒釋兵權
杰克尼克逊	傑克尼克遜
杰克盖伦海	傑克蓋倫海
杰克葛伦霍	傑克葛倫霍
杰弗里乔叟	傑弗里喬叟
杰森史塔森	傑森史塔森
杰米福克斯	傑米福克斯
杰西詹姆斯	傑西詹姆斯
松了一口气	鬆了一口氣
松柏长青茶	松柏長青茶
松花江平原	松花江平原
松赞干布陵	松贊干布陵
板板六十四	板板六十四
极低频辐射	極低頻輻射
枕状玄武岩	枕狀玄武岩
林克平大学	林克平大學
林德布拉德	林德布拉德
枪打出头鸟	槍打出頭鳥
柏纳马修兹	柏納馬修茲
柏罗米修斯	柏羅米修斯
柯尔克孜族	柯爾克孜族
柯尔克孜语	柯爾克孜語
柴油发动机	柴油發動機
标准细分表	標準細分表
核出口控制	核出口控制
核爆炸烟云	核爆炸煙雲
核电磁脉冲	核電磁脈衝
核能发电厂	核能發電廠
核融合发电	核融合發電
格列佛游记	格列佛遊記
格列高利历	格列高利曆
格勒诺布尔	格勒諾布爾
格里姆斯塔	格里姆斯塔
格里高利历	格里高利曆
桑托里尼岛	桑托里尼島
梅尼尔氏症	梅尼爾氏症
梅德韦杰夫	梅德韋傑夫
梅西叶星表	梅西葉星表
梅西耶星表	梅西耶星表
梦工厂动画	夢工廠動畫
梦有五不占	夢有五不占
梯恩梯当量	梯恩梯當量
棒下出孝子	棒下出孝子
棒头出孝子	棒頭出孝子
森林游乐区	森林遊樂區
森林生态系	森林生態系
棺材里伸手	棺材裏伸手
槭叶止血草	槭葉止血草
模范大音阶	模範大音階
模范棒棒堂	模範棒棒堂
横打鼻梁儿	橫打鼻梁兒
欧式几何学	歐式幾何學
欧氏几何学	歐氏幾何學
欧洲共同体	歐洲共同體
欧洲火药库	歐洲火藥庫
欧罗巴人种	歐羅巴人種
欧里庇得斯	歐里庇得斯
欲穷千里目	欲窮千里目
欲速则不达	欲速則不達
欲速而不达	欲速而不達
正义发展党	正義發展黨
武梁祠画像	武梁祠畫像
殊域周咨录	殊域周咨錄
残春雾雨余	殘春霧雨餘
每端口价格	每端口價格
比例代表制	比例代表制
毛厕里砖儿	毛廁裏磚兒
毛司里砖儿	毛司裏磚兒
毛坑没后壁	毛坑沒後壁
毛里塔尼亚	毛里塔尼亞
民主进步党	民主進步黨
民主集中制	民主集中制
气管切开术	氣管切開術
气管插管术	氣管插管術
氢净合成油	氫淨合成油
水上摩托车	水上摩托車
水力发电站	水力發電站
水底写字板	水底寫字板
水来汤里去	水來湯裏去
水磨腔曲子	水磨腔曲子
水轮发动机	水輪發動機
永丰舰事件	永豐艦事件
汉书艺文志	漢書藝文志
汉城特别市	漢城特別市
汉满蒙回藏	漢滿蒙回藏
汗腾格里山	汗騰格里山
汗腾格里峰	汗騰格里峰
江村销夏录	江村銷夏錄
污水处理厂	汙水處理廠
汤姆历险记	湯姆歷險記
汽轮发电机	汽輪發電機
沙依巴克区	沙依巴克區
沙漠生态系	沙漠生態系
没个好结果	沒個好結果
没地里巡检	沒地裏巡檢
没当家花花	沒當家花花
没讨个空处	沒討個空處
油电混合车	油電混合車
法兰克欧兹	法蘭克歐茲
法制办公室	法制辦公室
法国共产党	法國共產黨
法定准备率	法定準備率
波勒瓦裘克	波勒瓦裘克
波多马克河	波多馬克河
波尔卡舞曲	波爾卡舞曲
波尔干地区	波爾干地區
波托马克河	波托馬克河
波里尼西亚	波里尼西亞
波雷罗舞曲	波雷羅舞曲
泰坦尼克号	泰坦尼克號
泰特美术馆	泰特美術館
洗钱防制法	洗錢防制法
洛可可美术	洛可可美術
洛皮塔瀑布	洛皮塔瀑布
洪都百炼生	洪都百鍊生
流体冶金术	流體冶金術
测地线曲率	測地綫曲率
浙江天台县	浙江天台縣
海水淡化厂	海水淡化廠
海洋生态系	海洋生態系
海淀图书城	海淀圖書城
消费合作社	消費合作社
涨跌幅限制	漲跌幅限制
液压千斤顶	液壓千斤頂
淀粉类作物	澱粉類作物
淡水生态系	淡水生態系
深山何处钟	深山何處鐘
深山出俊鸟	深山出俊鳥
混合动力车	混合動力車
混合失语症	混合失語症
清水下杂面	清水下雜麵
游僧攒住持	游僧攢住持
游民收容所	遊民收容所
游游磨磨儿	遊遊磨磨兒
湿肉伴干柴	溼肉伴乾柴
滚石合唱团	滾石合唱團
漏斗状花冠	漏斗狀花冠
潜意识历程	潛意識歷程
澎湖天后宫	澎湖天后宮
澳新军团日	澳新軍團日
激光二极管	激光二極管
瀍河回族区	瀍河回族區
火力发电厂	火力發電廠
火药味甚浓	火藥味甚濃
灯台不自照	燈臺不自照
炭水化合物	炭水化合物
炼丹八卦炉	煉丹八卦爐
炽热火山云	熾熱火山雲
烟酒公卖局	菸酒公賣局
烤胡椒香肠	烤胡椒香腸
燃料处理厂	燃料處理廠
燕云十六州	燕雲十六州
爬虫类动物	爬蟲類動物
爱克斯射线	愛克斯射綫
爱心刮刮乐	愛心刮刮樂
片面最惠国	片面最惠國
牙买加胡椒	牙買加胡椒
牛骥同一皁	牛驥同一皁
牵引发电机	牽引發電機
特别任务连	特別任務連
特别公积金	特別公積金
特别扣除额	特別扣除額
特别提款权	特別提款權
特别行政区	特別行政區
特征多项式	特徵多項式
特种空勤团	特種空勤團
狮身人面像	獅身人面像
猢狲入布袋	猢猻入布袋
猪链球菌病	豬鏈球菌病
玄武质熔岩	玄武質熔岩
现金流量表	現金流量表
珊卓布拉克	珊卓布拉克
珍娜杰克森	珍娜傑克森
班克拉夫特	班克拉夫特
班艾伏列克	班艾伏列克
班艾佛列克	班艾佛列克
球后辛吉丝	球后辛吉絲
球面几何学	球面幾何學
琅邪台刻石	琅邪臺刻石
琴斯托霍瓦	琴斯托霍瓦
瓦尔达克省	瓦爾達克省
生产合作社	生產合作社
生命共同体	生命共同體
生态环境游	生態環境游
生旦淨末丑	生旦淨末丑
田园交响曲	田園交響曲
甲种国库券	甲種國庫券
甲种维生素	甲種維生素
电子布告栏	電子布告欄
电影分级制	電影分級制
电影回顾展	電影回顧展
电脑系统业	電腦系統業
电视兴奋症	電視興奮症
电视游乐器	電視遊樂器
电话答录机	電話答錄機
男修道院长	男修道院長
留美同学会	留美同學會
疑心生暗鬼	疑心生暗鬼
疾风扫秋叶	疾風掃秋葉
登革出血热	登革出血熱
白面僧面猴	白面僧面猴
百万分之一	百萬分之一
百分之一千	百分之一千
皇家马德里	皇家馬德里
皮划艇静水	皮劃艇靜水
益州名画录	益州名畫錄
盐打怎么咸	鹽打怎麼鹹
盒式录音带	盒式錄音帶
目短于自见	目短於自見
直流发电机	直流發電機
直落布兰雅	直落布蘭雅
真后生动物	真後生動物
真草千字文	真草千字文
眼球干燥症	眼球乾燥症
石英卤素灯	石英鹵素燈
研发替代役	研發替代役
碳氢化合物	碳氫化合物
碳水化合物	碳水化合物
碳的化合物	碳的化合物
磨石粗砂岩	磨石粗砂岩
社交恐惧症	社交恐懼症
社会民主党	社會民主黨
祖国光复会	祖國光復會
神经纤维瘤	神經纖維瘤
票据交易所	票據交易所
福克兰羣岛	福克蘭羣島
福克兰群岛	福克蘭羣島
离婚同意书	離婚同意書
离弦走板儿	離弦走板兒
禾谷类作物	禾穀類作物
私有财产制	私有財產制
秋阴入井干	秋陰入井幹
秋风扫落叶	秋風掃落葉
种族主义者	種族主義者
种近乎幻想	種近乎幻想
科布多盆地	科布多盆地
科技示范户	科技示範戶
税捐稽征处	稅捐稽徵處
稳坐钓鱼台	穩坐釣魚臺
穆斯坦西里	穆斯坦西里
穆罕默德历	穆罕默德曆
穗帏飘井干	繐幃飄井幹
空中管制站	空中管制站
空前绝后后	空前絕后後
空梁落燕泥	空梁落燕泥
空气缓冲间	空氣緩衝間
窝阔台汗国	窩闊臺汗國
窨子里秋月	窨子裏秋月
立体身历声	立體身歷聲
立宪民主党	立憲民主黨
立联合医院	立聯合醫院
竞争和聚合	競爭和聚合
笑代表拒绝	笑代表拒絕
笔划检字表	筆劃檢字表
第一个层次	第一個層次
第一准备金	第一準備金
等周不等式	等周不等式
简易包扎法	簡易包紮法
算术平均数	算術平均數
管城回族区	管城回族區
篮下三秒钟	籃下三秒鐘
米德尔伯里	米德爾伯裏
米雅托维奇	米雅托維奇
类别的团体	類別的團體
粉团儿似的	粉團兒似的
精神分裂症	精神分裂症
精神官能症	精神官能症
糊涂油蒙心	糊塗油蒙心
糖堆里养的	糖堆裏養的
糙面内质网	糙面內質網
糟齿类爬虫	糟齒類爬蟲
系列放大器	系列放大器
系列电视剧	系列電視劇
系统抽样法	系統抽樣法
系统流程图	系統流程圖
索福克勒斯	索福克勒斯
索福克里斯	索福克裏斯
红叶少棒队	紅葉少棒隊
红色娘子军	紅色娘子軍
纤维囊泡症	纖維囊泡症
纤维蛋白原	纖維蛋白原
约翰麦克连	約翰麥克連
纪录创造者	紀錄創造者
纳克希班迪	納克希班迪
纳波里塔诺	納波里塔諾
组立式建筑	組立式建築
维几尼亚州	維幾尼亞州
维尔布鲁根	維爾布魯根
维科扬斯克	維科揚斯克
维苏威火山	維蘇威火山
综合所得税	綜合所得稅
综合扩大机	綜合擴大機
网路六合彩	網路六合彩
网路印表机	網路印表機
网路链接层	網路鏈接層
罗德里奎兹	羅德里奎茲
罗德里格兹	羅德里格茲
罗德里格斯	羅德里格斯
罗德里盖兹	羅德里蓋茲
羊膜穿刺术	羊膜穿刺術
美国参议院	美國參議院
老人失智症	老人失智症
老人癡呆症	老人癡呆症
老和尚撞钟	老和尚撞鐘
老年痴呆症	老年癡呆症
老年癡呆症	老年癡呆症
老蚌出明珠	老蚌出明珠
耍得团团转	耍得團團轉
耶稣升天节	耶穌升天節
职业代表制	職業代表制
职业倦怠症	職業倦怠症
联合古大陆	聯合古大陸
联合国大会	聯合國大會
联合国宪章	聯合國憲章
联合国粮农	聯合國糧農
联合收割机	聯合收割機
联合收获机	聯合收穫機
联合通讯社	聯合通訊社
肌肉松弛剂	肌肉鬆弛劑
肌肉萎缩症	肌肉萎縮症
肚子里点灯	肚子裏點燈
肚里的蛔虫	肚裏的蛔蟲
肯定并例句	肯定並例句
肿瘤切除术	腫瘤切除術
胃酸过多症	胃酸過多症
胡克斯特拉	胡克斯特拉
胡桃钳组曲	胡桃鉗組曲
胡笳十八拍	胡笳十八拍
胡适纪念馆	胡適紀念館
胡马依北风	胡馬依北風
胸廓切开术	胸廓切開術
能说不能干	能說不能幹
脉冲电磁场	脈衝電磁場
脑力激荡术	腦力激盪術
脑力激荡法	腦力激盪法
脑成像技术	腦成像技術
腊之以为饵	腊之以爲餌
腕道症候羣	腕道症候羣
腾格里沙漠	騰格裏沙漠
臀位取胎术	臀位取胎術
自动化技术	自動化技術
自动柜员机	自動櫃員機
自由民主党	自由民主黨
致死性毒剂	致死性毒劑
船边交货价	船邊交貨價
色彩三要素	色彩三要素
艾克森美孚	艾克森美孚
艾克雷史东	艾克雷史東
艾斯托利尔	艾斯托利爾
节奏布鲁斯	節奏布魯斯
芥子纳须弥	芥子納須彌
花岗岩质层	花崗岩質層
苍蝇掐了头	蒼蠅掐了頭
苏丹共和国	蘇丹共和國
苏丹达佛区	蘇丹達佛區
苏伊士运河	蘇伊士運河
苏俄在中国	蘇俄在中國
苏富比公司	蘇富比公司
苏尼特右旗	蘇尼特右旗
苏尼特左旗	蘇尼特左旗
苏彝士运河	蘇彝士運河
苏必利尔湖	蘇必利爾湖
苏拉威西岛	蘇拉威西島
苏珊莎兰登	蘇珊莎蘭登
苏维埃俄国	蘇維埃俄國
苏联之友社	蘇聯之友社
苏联共产党	蘇聯共產黨
苏菲亚罗兰	蘇菲亞羅蘭
苏门答腊岛	蘇門答臘島
苏门答腊省	蘇門答臘省
苏门达腊岛	蘇門達臘島
苛政猛于虎	苛政猛於虎
苜蓿长栏干	苜蓿長欄干
英联合王国	英聯合王國
英雄交响曲	英雄交響曲
苹果子姜尼	蘋果子姜尼
范德格拉夫	範德格拉夫
范德瓦耳斯	範德瓦耳斯
茑萝施乔松	蔦蘿施喬松
茨万吉拉伊	茨萬吉拉伊
荤油蒙了心	葷油蒙了心
莎玛海耶克	莎瑪海耶克
莫乃耳合金	莫乃耳合金
菲茨杰拉德	菲茨傑拉德
萨克洛夫奖	薩克洛夫獎
萨尔布吕肯	薩爾布呂肯
落个直过儿	落個直過兒
落叶归根家	落葉歸根家
葛兰素史克	葛蘭素史克
葛罗托斯基	葛羅托斯基
蒂森克虏伯	蒂森克虜伯
蒋总统秘录	蔣總統秘錄
蒙兀儿帝国	蒙兀兒帝國
蒙太奇电影	蒙太奇電影
蒙得维的亚	蒙得維的亞
蒙特內哥罗	蒙特內哥羅
蒙特卡洛法	矇特卡洛法
蒙特塞拉特	蒙特塞拉特
蒙藏委员会	蒙藏委員會
蔷薇十字团	薔薇十字團
薰莸不同器	薰蕕不同器
虎山艺术馆	虎山藝術館
蛇绿混杂岩	蛇綠混雜岩
蛟龙得云雨	蛟龍得雲雨
螺旋千斤顶	螺旋千斤頂
蟠尾丝虫症	蟠尾絲蟲症
蟹黄鲍鱼面	蟹黃鮑魚麵
蠹啄剖梁柱	蠹啄剖梁柱
血液恐怖症	血液恐怖症
血脂升高症	血脂升高症
行为艺术者	行爲藝術者
行政区划图	行政區劃圖
行星状星云	行星狀星雲
行行出状元	行行出狀元
表意符阶段	表意符階段
表格化公文	表格化公文
表皮剥脱素	表皮剝脫素
表达失语症	表達失語症
表面活化剂	表面活化劑
表面活性剂	表面活性劑
被害妄想症	被害妄想症
被窝里放屁	被窩裏放屁
裂变同位素	裂變同位素
裂谷热病毒	裂谷熱病毒
裴航遇云英	裴航遇雲英
西尼克学派	西尼克學派
西王母娘娘	西王母娘娘
西里尔字母	西裏爾字母
见面三分情	見面三分情
规范化管理	規範化管理
规范性文件	規範性文件
视空间系统	視空間系統
角膜移植术	角膜移植術
解析几何学	解析幾何學
言语失常症	言語失常症
言隐于荣华	言隱於榮華
詹姆士布朗	詹姆士布朗
詹姆斯布朗	詹姆斯布朗
计算机制图	計算機制圖
证卷交易所	證卷交易所
词汇判断法	詞彙判斷法
话又说回来	話又說回來
语音失语症	語音失語症
语音数据机	語音數據機
说不出话来	說不出話來
说单生万岁	說單生萬歲
说文解字注	說文解字註
说话不当话	說話不當話
调制解调器	調制解調器
谱系分类法	譜系分類法
败血性休克	敗血性休克
败血脓毒症	敗血膿毒症
贪杯惜醉人	貪杯惜醉人
费尔法克斯	費爾法克斯
费茨派垂克	費茨派垂克
资产负债表	資產負債表
资料链结层	資料鏈結層
赖索托王国	賴索托王國
赤道几內亚	赤道幾內亞
赤道几内亚	赤道幾內亞
赫克迈泰尔	赫克邁泰爾
赫拉克利特	赫拉克利特
赫里斯登科	赫里斯登科
赫麦汉士台	赫麥漢士臺
走了大褶儿	走了大褶兒
赶前不赶后	趕前不趕後
超友谊关系	超友誼關係
超大曲道赛	超大曲道賽
超完美告别	超完美告別
超新星剩余	超新星剩餘
超计划利润	超計劃利潤
越南共产党	越南共產黨
越活越回去	越活越回去
跨媒体合作	跨媒體合作
躁狂抑郁症	躁狂抑鬱症
身份识别卡	身份識別卡
车到没恶路	車到沒惡路
输入许可制	輸入許可制
达沃斯论坛	達沃斯論壇
过敏性休克	過敏性休克
过滤嘴香烟	過濾嘴香菸
进一步规范	進一步規範
进口加签权	進口加簽權
进步伙伴展	進步夥伴展
迟发性损伤	遲發性損傷
迪拉萨布里	迪拉薩布里
退伍军人症	退伍軍人症
逆转录病毒	逆轉錄病毒
选校不选系	選校不選系
选民参加率	選民參加率
选系不选校	選系不選校
造血干细胞	造血幹細胞
遗体告别式	遺體告別式
郇山隐修会	郇山隱修會
鄂托克前旗	鄂托克前旗
鄂霍次克海	鄂霍次克海
配位化合物	配位化合物
酒后吐真言	酒後吐真言
酒病酒药医	酒病酒藥醫
里外不是人	裏外不是人
里奥格兰德	里奧格蘭德
里希特霍芬	里希特霍芬
里特维宁科	里特維寧科
里约热內卢	里約熱內盧
里约热内卢	里約熱內盧
金钱非万能	金錢非萬能
鉴定委员会	鑑定委員會
针孔摄影机	針孔攝影機
针孔照像机	針孔照像機
钓鱼台列岛	釣魚臺列島
钟不扣不鸣	鐘不扣不鳴
钟不撞不鸣	鐘不撞不鳴
钟不敲不响	鐘不敲不響
钟不空则哑	鐘不空則啞
钟表的历史	鐘錶的歷史
钩花点叶派	鉤花點葉派
钱眼里安身	錢眼裏安身
钻井平台数	鑽井平臺數
铁杵磨成针	鐵杵磨成針
铜斗儿家缘	銅斗兒家緣
银本位制度	銀本位制度
银样蜡鎗头	銀樣蠟鎗頭
银色冲浪手	銀色衝浪手
铺面临街房	鋪面臨街房
错误的结合	錯誤的結合
镭射印表机	鐳射印表機
门缝里看人	門縫裏看人
门面铺席人	門面鋪席人
问卷大调査	問卷大調査
问卷调査表	問卷調査表
闷着头儿干	悶着頭兒幹
闹了半天鬼	鬧了半天鬼
阑尾切除术	闌尾切除術
防患于未然	防患於未然
防空识别区	防空識別區
阴极射线管	陰極射綫管
阴沟里翻船	陰溝裏翻船
阿克苏地区	阿克蘇地區
阿兹海默症	阿茲海默症
阿列克西斯	阿列克西斯
阿尔发粒子	阿爾發粒子
阿尔梅里亚	阿爾梅里亞
阿布扎比市	阿布扎比市
阿布杜拉曼	阿布杜拉曼
阿布沙伊夫	阿布沙伊夫
阿布沙耶夫	阿布沙耶夫
阿布贾里布	阿布賈里布
阿弥陀如来	阿彌陀如來
阿拉干山脉	阿拉乾山脈
阿曼苏丹国	阿曼蘇丹國
阿柏克兹亚	阿柏克茲亞
阿波罗计划	阿波羅計劃
阿滋海默症	阿滋海默症
阿米巴原虫	阿米巴原蟲
阿米纳达布	阿米納達布
阿耳忒弥斯	阿耳忒彌斯
阿芝特克人	阿芝特剋人
阿芝特克语	阿芝特剋語
阿赫蒂萨里	阿赫蒂薩裏
阿里山之歌	阿里山之歌
阿里山山脉	阿里山山脈
阿里斯托芬	阿里斯托芬
阿里斯托芳	阿里斯託芳
限制酶图谱	限制酶圖譜
隔山观虎斗	隔山觀虎鬥
隔年的皇历	隔年的皇曆
雅鲁藏布江	雅魯藏布江
集会游行法	集會遊行法
雌雄同体人	雌雄同體人
雪狮子向火	雪獅子向火
雷克坦跑道	雷克坦跑道
雷克斯暴龙	雷克斯暴龍
雷克雅维克	雷克雅維克
雷夫范恩斯	雷夫范恩斯
雷射印表机	雷射印表機
雷德克里夫	雷德克里夫
雷昂卡发洛	雷昂卡發洛
雷神进行曲	雷神進行曲
雷贾帕克斯	雷賈帕克斯
霍尔布鲁克	霍爾布魯克
霓裳羽衣曲	霓裳羽衣曲
青年救国团	青年救國團
青果合作社	青果合作社
靖康传信录	靖康傳信錄
静脉血栓症	靜脈血栓症
非形象艺术	非形象藝術
非欧几何学	非歐幾何學
非洲出血热	非洲出血熱
非洲大裂谷	非洲大裂谷
非洲锥虫病	非洲錐蟲病
非营业支出	非營業支出
非贸易创汇	非貿易創匯
面子上的人	面子上的人
面子上的话	面子上的話
面色如金纸	面色如金紙
革命积极性	革命積極性
顺河回族区	順河回族區
顽童历险记	頑童歷險記
顾前不顾后	顧前不顧後
颅盖內出血	顱蓋內出血
额我略历史	額我略歷史
额贺福志郎	額賀福志郎
风云人物奖	風雲人物獎
风吹两面倒	風吹兩面倒
飞出个未来	飛出個未來
飞行记录仪	飛行記錄儀
飞行记录器	飛行記錄器
食用蜡烛木	食用蠟燭木
饥者易为食	飢者易爲食
饥者甘糟糠	飢者甘糟糠
饭店里买葱	飯店裏買蔥
饭饱生余事	飯飽生餘事
饱和化合物	飽和化合物
饱当知人饥	飽當知人飢
饱暖思淫欲	飽暖思淫慾
饱暖生淫欲	飽暖生淫慾
馀粮收集制	餘糧收集制
首尔特别市	首爾特別市
香格里拉县	香格裏拉縣
香榭里大道	香榭里大道
马丁杜里荷	馬丁杜里荷
马克安东尼	馬克安東尼
马克思主义	馬克思主義
马克斯主义	馬克斯主義
马克斯威尔	馬克斯威爾
马克沁机枪	馬克沁機槍
马克西米连	馬克西米連
马厝卡舞曲	馬厝卡舞曲
马太受难曲	馬太受難曲
马戏团表演	馬戲團表演
马托格罗索	馬託格羅索
马拉松赛跑	馬拉松賽跑
马死黄金尽	馬死黃金盡
马赛进行曲	馬賽進行曲
马里内斯科	馬里內斯科
骨质疏松症	骨質疏鬆症
骨质石化症	骨質石化症
骨质软化症	骨質軟化症
高处不胜寒	高處不勝寒
高致病性禽	高致病性禽
鬼门上占卦	鬼門上占卦
鲁毕克方块	魯畢克方塊
鸡犬识新丰	雞犬識新豐
鹰嘴豆面粉	鷹嘴豆麵粉
麦克格雷格	麥克格雷格
麦克白夫人	麥克白夫人
麦克雷兰说	麥克雷蘭說
麦可杰克森	麥可傑克森
麦哲伦星云	麥哲倫星雲
麦当劳叔叔	麥當勞叔叔
麦考马克说	麥考馬克說
麻姑仙坛记	麻姑仙壇記
黄曲霉毒素	黃曲黴毒素
黄河大合唱	黃河大合唱
黄石大峡谷	黃石大峽谷
黄菓树瀑布	黃菓樹瀑布
黎曼几何学	黎曼幾何學
黑奴吁天录	黑奴籲天錄
黑色棘皮症	黑色棘皮症
齿条千斤顶	齒條千斤頂
