一个富贵心两只体面眼	一個富貴心兩隻體面眼
一个幽灵在欧洲游荡	一個幽靈在歐洲遊蕩
一个红脸一个白脸	一個紅臉一個白臉
一个萝卜一个坑儿	一個蘿蔔一個坑兒
一个跟斗十万八千里	一個跟斗十萬八千里
一个钱打二十四个结	一個錢打二十四個結
一个馒头也得蒸熟吃	一個饅頭也得蒸熟吃
一争两丑一让两有	一爭兩醜一讓兩有
一人之下万人之上	一人之下萬人之上
一人传虚万人传实	一人傳虛萬人傳實
一人得道鸡犬升天	一人得道雞犬升天
一佛出世二佛涅槃	一佛出世二佛涅槃
一佛出世二佛生天	一佛出世二佛生天
一分耕耘一分收获	一分耕耘一分收穫
一制性资源定位法	一制性資源定位法
一只碗不响两只碗叮当	一隻碗不響兩隻碗叮噹
一叶蔽目不见泰山	一葉蔽目不見泰山
一叶障目不见泰山	一葉障目不見泰山
一块羊肉落在狗口里	一塊羊肉落在狗口裏
一夫当关万夫莫开	一夫當關萬夫莫開
一夫当关万夫莫敌	一夫當關萬夫莫敵
一子出家七祖升天	一子出家七祖昇天
一字入公门九牛拔不出	一字入公門九牛拔不出
一家一个主一庙一个神	一家一個主一廟一個神
一将守关万夫莫开	一將守關萬夫莫開
一斗米养个恩人一石米养个仇人	一斗米養個恩人一石米養個仇人
一日不见如隔三秋	一日不見如隔三秋
一日叫娘终身是母	一日叫孃終身是母
一沐三握发一饭三吐哺	一沐三握髮一飯三吐哺
一百只麻雀炒成一盘菜	一百隻麻雀炒成一盤菜
一胎生两三个孩子	一胎生兩三個孩子
一般废弃物回收清除处理基金会	一般廢棄物回收清除處理基金會
一言已定千金不移	一言已定千金不移
一言既出驷马难追	一言既出駟馬難追
一龙生九种种种各别	一龍生九種種種各別
万事俱备只欠东风	萬事俱備只欠東風
万般皆下品惟有读书高	萬般皆下品惟有讀書高
万般皆是命半点不由人	萬般皆是命半點不由人
丈母娘看女婿越看越有趣	丈母孃看女婿越看越有趣
三个臭皮匠合成一个诸葛亮	三個臭皮匠合成一個諸葛亮
三个臭皮匠胜过诸葛亮	三個臭皮匠勝過諸葛亮
三个臭皮匠赛过一个诸葛亮	三個臭皮匠賽過一個諸葛亮
三个臭皮匠赛过诸葛亮	三個臭皮匠賽過諸葛亮
三个臭皮匠顶个诸葛亮	三個臭皮匠頂個諸葛亮
三人同心其利断金	三人同心其利斷金
三人抬不过个理字	三人擡不過個理字
三军可夺帅匹夫不可夺志	三軍可奪帥匹夫不可奪志
三军未发粮草先行	三軍未發糧草先行
三十二位元个人电脑	三十二位元個人電腦
三十六个牙齿捉对儿厮打	三十六個牙齒捉對兒廝打
三年不上门当亲也不亲	三年不上門當親也不親
三日不读书面目可憎	三日不讀書面目可憎
三百六十行行行出状元	三百六十行行行出狀元
上有天堂下有苏杭	上有天堂下有蘇杭
上海宝钢集团公司	上海寶鋼集團公司
上海文广新闻传媒集团	上海文廣新聞傳媒集團
上海汽车工业集团	上海汽車工業集團
上海浦东发展银行	上海浦東發展銀行
上海证券交易所综合股价指	上海證券交易所綜合股價指
不图打点只图混水	不圖打點只圖混水
不孝有三无后为大	不孝有三無後爲大
不干不淨吃了没病	不乾不淨吃了沒病
不怕一万就怕万一	不怕一萬就怕萬一
不怕县官只怕现管	不怕縣官只怕現管
不是东风压了西风就是西风压了东风	不是東風壓了西風就是西風壓了東風
不的个风儿就雨儿	不的個風兒就雨兒
不知出于何种原因	不知出於何種原因
不知葫芦里卖甚么药	不知葫蘆裏賣甚麼藥
不管生癣生疮我只生癞	不管生癬生瘡我只生癩
不管讲鸡讲鸭我只讲鹅	不管講雞講鴨我只講鵝
不能流芳百世也要遗臭万年	不能流芳百世也要遺臭萬年
不说话没人当你是哑吧	不說話沒人當你是啞吧
与君一席话胜读十年书	與君一席話勝讀十年書
丑媳妇总得要见公婆	醜媳婦總得要見公婆
世上无难事只怕有心人	世上無難事只怕有心人
世情看冷暖人面逐高低	世情看冷暖人面逐高低
世界维吾尔代表大会	世界維吾爾代表大會
东作既失秋成无望	東作既失秋成無望
东边日出西边下雨	東邊日出西邊下雨
两只脚赶不上一张嘴	兩隻腳趕不上一張嘴
两岸人民关系条例	兩岸人民關係條例
两虎相斗必有一伤	兩虎相鬥必有一傷
中华学生爱国民主同盟	中華學生愛國民主同盟
中华文化复兴运动	中華文化復興運動
中华文化复兴运动总会	中華文化復興運動總會
中华苏维埃共和国	中華蘇維埃共和國
中台医事技术专科学校	中臺醫事技術專科學校
中台医护技术学院	中臺醫護技術學院
中国共产主义青年团	中國共產主義青年團
中国共产党中央委员会	中國共產黨中央委員會
中国共产党中央委员会宣传部	中國共產黨中央委員會宣傳部
中国国民党革命委员会	中國國民黨革命委員會
中国国际信托投资公司	中國國際信托投資公司
中国国际广播电台	中國國際廣播電臺
中国大百科全书出版社	中國大百科全書出版社
中国文学艺术界联合会	中國文學藝術界聯合會
中国残疾人联合会	中國殘疾人聯合會
中国游艺机游乐园协会	中國遊藝機遊樂園協會
中国石油天然气集团公司	中國石油天然氣集團公司
中国精密机械进出口公司	中國精密機械進出口公司
中国航天技术进出口公司	中國航天技術進出口公司
中国船舶重工集团公司	中國船舶重工集團公司
中国青年反共救国团	中國青年反共救國團
中心埋置关系从句	中心埋置關係從句
中日韩统一表意文字	中日韓統一表意文字
中苏解决悬案大纲协定	中蘇解決懸案大綱協定
丰若有肌柔若无骨	豐若有肌柔若無骨
丹尼尔雷德克里夫	丹尼爾雷德克里夫
乌狗吃食白狗当灾	烏狗吃食白狗當災
乔修亚．吉尔菲艾斯	喬修亞．吉爾菲艾斯
九头牛也拽不出去	九頭牛也拽不出去
九寨沟风景名胜区	九寨溝風景名勝區
事不三思终有后悔	事不三思終有後悔
事不关己高高挂起	事不關己高高掛起
事修而谤兴德高而毁来	事修而謗興德高而毀來
事有斗巧物有故然	事有鬥巧物有故然
事物的本质重于外在	事物的本質重於外在
二人同心其利断金	二人同心其利斷金
二虎相斗必有一伤	二虎相鬥必有一傷
五度制调值标记法	五度制調值標記法
亚历山大杜布切克	亞歷山大杜布切克
亚太安全合作会议	亞太安全合作會議
亚太经济合作会议	亞太經濟合作會議
亚太经济合作组织	亞太經濟合作組織
人不可貌相海水不可斗量	人不可貌相海水不可斗量
人同此心心同此理	人同此心心同此理
人心不同各如其面	人心不同各如其面
人急悬梁狗急跳墙	人急懸梁狗急跳牆
人无千日好花无百日红	人無千日好花無百日紅
人是苦虫不打不招	人是苦蟲不打不招
人有千算天有一算	人有千算天有一算
人生一世草生一秋	人生一世草生一秋
人生不满百常怀千岁忧	人生不滿百常懷千歲憂
人生短暂学术无涯	人生短暫學術無涯
仇人相见分外眼红	仇人相見分外眼紅
从善如登从恶如崩	從善如登從惡如崩
仓老鼠和老鸹去借粮	倉老鼠和老鴰去借糧
任凭风浪起稳坐钓鱼台	任憑風浪起穩坐釣魚臺
伊犁哈萨克自治州	伊犁哈薩克自治州
但得一片橘皮吃且莫忘了洞庭湖	但得一片橘皮吃且莫忘了洞庭湖
你有千条妙计我有一定之规	你有千條妙計我有一定之規
信用卡线上订购系统	信用卡綫上訂購系統
借米下得锅讨米下不得锅	借米下得鍋討米下不得鍋
做一天和尚撞一天钟	做一天和尚撞一天鐘
儿不嫌母丑犬不怨主贫	兒不嫌母醜犬不怨主貧
元培医事技术学校	元培醫事技術學校
先天下之忧而忧后天下之乐而乐	先天下之憂而憂后天下之樂而樂
先天不足后天失调	先天不足後天失調
光纤分布式数据介面	光纖分佈式數據介面
光纤分布数据接口	光纖分佈數據接口
光纤分散式资料介面	光纖分散式資料介面
光纤通讯干道网路系统	光纖通訊幹道網路系統
克孜勒苏柯尔克孜自治州	克孜勒蘇柯爾克孜自治州
克孜尔尕哈烽火台	克孜爾尕哈烽火臺
克拉斯诺亚尔斯克	克拉斯諾亞爾斯克
克莱斯勒汽车公司	克萊斯勒汽車公司
入口匝道号志管制	入口匝道號誌管制
全世界无产者联合起来	全世界無產者聯合起來
全国人民代表大会	全國人民代表大會
全国人民代表大会常务委员会	全國人民代表大會常務委員會
全国敎育资讯服务系统	全國敎育資訊服務系統
全球位置测定系统	全球位置測定系統
全球卫星导航系统	全球衛星導航系統
全球定位系统卫星测量	全球定位系統衛星測量
全球环境变迁资讯系统	全球環境變遷資訊系統
全面禁止核试验条约	全面禁止核試驗條約
关岭布依族苗族自治县	關嶺布依族苗族自治縣
养儿待老积谷防饥	養兒待老積穀防饑
养儿防老积谷防饥	養兒防老積穀防飢
养兵千日用兵一时	養兵千日用兵一時
养兵千日用在一时	養兵千日用在一時
养兵千日用在一朝	養兵千日用在一朝
养军千日用军一时	養軍千日用軍一時
养军千日用在一时	養軍千日用在一時
养军千日用在一朝	養軍千日用在一朝
养子防老积谷防饥	養子防老積穀防飢
养小防老积谷防饥	養小防老積穀防饑
兼听则明偏信则暗	兼聽則明偏信則暗
军品出口领导小组	軍品出口領導小組
农村家庭联产承包责任制	農村家庭聯產承包責任制
冠状动脉旁路移植手术	冠狀動脈旁路移植手術
冠状动脉旁通手术	冠狀動脈旁通手術
冰生于水而寒于水	冰生於水而寒於水
几內亚比索共和国	幾內亞比索共和國
凡事总有一个开头	凡事總有一個開頭
出其不意攻其不备	出其不意攻其不備
分久必合合久必分	分久必合合久必分
别人的孩子死不完	別人的孩子死不完
别人肉帖不在腮颊上	別人肉帖不在腮頰上
前不巴村后不巴店	前不巴村後不巴店
前事不忘后事之师	前事不忘後事之師
前人失脚后人把滑	前人失腳後人把滑
前人撒土迷了后人的眼	前人撒土迷了後人的眼
前人栽树后人乘凉	前人栽樹後人乘涼
前无古人后无来者	前無古人後無來者
前车之覆后车之鉴	前車之覆後車之鑑
前郭尔罗斯蒙古族自治县	前郭爾羅斯蒙古族自治縣
前门不进师姑后门不进和尚	前門不進師姑後門不進和尚
前门打虎后门打狼	前門打虎後門打狼
前门拒虎后门进狼	前門拒虎後門進狼
力田不如逢年善仕不如遇合	力田不如逢年善仕不如遇合
功能磁共振成像术	功能磁共振成像術
加勒比海共同市场	加勒比海共同市場
北京国家游泳中心	北京國家游泳中心
北京汽车制造厂有限公司	北京汽車製造廠有限公司
十个明星当不的月	十個明星當不的月
十八的姑娘一朵花	十八的姑娘一朵花
十六位元个人电脑	十六位元個人電腦
千军易得一将难求	千軍易得一將難求
千差万差来人不差	千差萬差來人不差
千算万算不值天一划	千算萬算不值天一劃
千羊之皮不如一狐之腋	千羊之皮不如一狐之腋
千里之堤溃于蚁穴	千里之堤潰於蟻穴
千里之行始于足下	千里之行始於足下
千里做官为的吃穿	千里做官爲的吃穿
千里达及托巴哥共和国	千里達及托巴哥共和國
千里送鹅毛礼轻人意重	千里送鵝毛禮輕人意重
千里送鹅毛礼轻情意重	千里送鵝毛禮輕情意重
千里馈粮士有饥色	千里饋糧士有飢色
千金之子坐不垂堂	千金之子坐不垂堂
千金之裘非一狐之腋	千金之裘非一狐之腋
千镒之裘非一狐之白	千鎰之裘非一狐之白
单端孢霉烯类毒素中毒症	單端孢黴烯類毒素中毒症
卖炭的掉在面缸里	賣炭的掉在麵缸裏
卖荳腐点了河滩地	賣荳腐點了河灘地
南亚区域合作联盟	南亞區域合作聯盟
博尔塔拉蒙古自治州	博爾塔拉蒙古自治州
原发性进行性失语	原發性進行性失語
双江拉祜族佤族布朗族傣族自治县	雙江拉祜族佤族布朗族傣族自治縣
发行量加权股价指数	發行量加權股價指數
取之不尽用之不竭	取之不盡用之不竭
只可意会不可言传	只可意會不可言傳
只有出的气没有进的气	只有出的氣沒有進的氣
只此一家别无分店	只此一家別無分店
只知其一不知其二	只知其一不知其二
只知有己不知有人	只知有己不知有人
只要功夫深铁杵磨成针	只要功夫深鐵杵磨成針
只见树木不见森林	只見樹木不見森林
只许州官放火不许百姓点灯	只許州官放火不許百姓點燈
可擦写可编程只读存储器	可擦寫可編程只讀存儲器
台北地理资讯系统	臺北地理資訊系統
台北工业专科学校	臺北工業專科學校
台北市政府捷运工程局	臺北市政府捷運工程局
台北市立体育学院	臺北市立體育學院
台北市立师范学校	臺北市立師範學校
台北市立敎育大学	臺北市立敎育大學
台北护理专科学校	臺北護理專科學校
台南女子技术学院	臺南女子技術學院
台南家政专科学校	臺南家政專科學校
台南科学工业园区	臺南科學工業園區
台湾大学附属医学院	臺灣大學附屬醫學院
台湾工业技术学院	臺灣工業技術學院
台湾民主自治同盟	臺灣民主自治同盟
台湾汽车客运公司	臺灣汽車客運公司
台湾省政府敎育厅	臺灣省政府敎育廳
台湾省政府林业试验所	臺灣省政府林業試驗所
台湾省政府消防处	臺灣省政府消防處
台湾省政府警政厅	臺灣省政府警政廳
台湾省政府财政厅	臺灣省政府財政廳
台湾艺术专科学校	臺灣藝術專科學校
台湾警察专科学校	臺灣警察專科學校
台湾证券集中保管公司	臺灣證券集中保管公司
吃了蜜蜂儿屎似的	吃了蜜蜂兒屎似的
吃人一个蛋恩情无法断	吃人一個蛋恩情無法斷
吃饭别忘了种谷人	吃飯別忘了種穀人
各人儿洗面儿各人儿光	各人兒洗面兒各人兒光
同一个世界同一个梦想	同一個世界同一個夢想
同步辐射研究中心	同步輻射研究中心
后天免疫缺乏症候羣	後天免疫缺乏症候羣
君子交绝不出恶声	君子交絕不出惡聲
君子坦荡荡小人长戚戚	君子坦蕩蕩小人長慼慼
君子报仇十年不晚	君子報仇十年不晚
周郎妙计高天下赔了夫人又折兵	周郎妙計高天下賠了夫人又折兵
和布克赛尔蒙古自治县	和布克賽爾蒙古自治縣
哈克贝利芬历险记	哈克貝利芬歷險記
哑巴吃黄连有苦说不出	啞巴吃黃連有苦說不出
唐胖子吊在醋缸里	唐胖子吊在醋缸裏
喀喇沁左翼蒙古族自治县	喀喇沁左翼蒙古族自治縣
善有善报恶有恶报	善有善報惡有惡報
善有善报恶有恶报若然不报时晨未到	善有善報惡有惡報若然不報時晨未到
喫亏的是乖占便宜的是呆	喫虧的是乖占便宜的是呆
嘉南药理科技大学	嘉南藥理科技大學
四体不勤五谷不分	四體不勤五穀不分
围场满族蒙古族自治县	圍場滿族蒙古族自治縣
国务院台湾事务办公室	國務院臺灣事務辦公室
国家发展和改革委员会	國家發展和改革委員會
国家发展计划委员会	國家發展計劃委員會
国家文物鉴定委员会	國家文物鑑定委員會
国家标准中文交换码	國家標準中文交換碼
国家标准化管理委员会	國家標準化管理委員會
国家永续发展论坛	國家永續發展論壇
国家空气品质标准	國家空氣品質標準
国家食品药品监督管理局	國家食品藥品監督管理局
国民常用字标准字体表	國民常用字標準字體表
国科会同步幅射研究中心	國科會同步幅射研究中心
国科会晶片设计制作中心	國科會晶片設計製作中心
国科会精密仪器发展中心	國科會精密儀器發展中心
国立台北科技大学	國立臺北科技大學
国立台湾技术大学	國立臺灣技術大學
国立敎育广播电台	國立敎育廣播電臺
国语注音符号第一式	國語注音符號第一式
国语注音符号第二式	國語注音符號第二式
国际奥林匹克委员会	國際奧林匹克委員會
国际漫游拨接服务	國際漫遊撥接服務
国际电影制片人协会联盟	國際電影製片人協會聯盟
国际羽毛球联合会	國際羽毛球聯合會
图书餐饮复合式餐厅	圖書餐飲複合式餐廳
圣皮埃尔和密克隆	聖皮埃爾和密克隆
在天愿做比翼鸟在地愿做连理枝	在天願做比翼鳥在地願做連理枝
在家千日好出门一时难	在家千日好出門一時難
在家靠父母出外靠朋友	在家靠父母出外靠朋友
坦尚尼亚联合共和国	坦尚尼亞聯合共和國
塔什库尔干塔吉克自治县	塔什庫爾干塔吉克自治縣
塔什库尔干自治县	塔什庫爾干自治縣
塞尔维亚克罗地亚语	塞爾維亞克羅地亞語
士别三日刮目相待	士別三日刮目相待
大不列颠与北爱尔兰联合王国	大不列顛與北愛爾蘭聯合王國
大事化小小事化了	大事化小小事化了
大湄公河次区域合作	大湄公河次區域合作
大白日里借不出个干灯盏来	大白日裏借不出個乾燈盞來
大目干连冥间救母变文	大目乾連冥間救母變文
大缸里翻油沿路拾芝麻	大缸裏翻油沿路拾芝麻
大通回族土族自治县	大通回族土族自治縣
大门不出二门不迈	大門不出二門不邁
大难不死必有后禄	大難不死必有後祿
大难不死必有后福	大難不死必有後福
天下大势分久必合合久必分	天下大勢分久必合合久必分
天下安注意相天下危注意将	天下安注意相天下危注意將
天下无难事只怕有心人	天下無難事只怕有心人
天无三日晴地无三里平	天無三日晴地無三里平
天有不测风云人有旦夕祸福	天有不測風雲人有旦夕禍福
天要下雨娘要嫁人	天要下雨孃要嫁人
天要落雨娘要嫁人	天要落雨孃要嫁人
太公钓鱼愿者上钩	太公釣魚願者上鉤
太阳照在桑干河上	太陽照在桑乾河上
失之毫厘差之千里	失之毫釐差之千里
失之毫厘差以千里	失之毫釐差以千里
失之毫厘谬以千里	失之毫厘謬以千里
头上打一下脚底板响	頭上打一下腳底板響
头脑简单四肢发达	頭腦簡單四肢發達
奥林匹克运动会组织委员会	奧林匹克運動會組織委員會
好事不出门坏事传千里	好事不出門壞事傳千里
好事不出门恶事传千里	好事不出門惡事傳千里
好事不出门恶事行千里	好事不出門惡事行千里
好人不长寿祸害一千年	好人不長壽禍害一千年
好借好还再借不难	好借好還再借不難
好好学习天天向上	好好學習天天向上
好心倒做了驴肝肺	好心倒做了驢肝肺
好时是他人恶时是家人	好時是他人惡時是家人
姜太公钓鱼愿者上钩	薑太公釣魚願者上鉤
威宁彝族回族苗族自治县	威寧彝族回族苗族自治縣
嫁出去的女儿泼出去的水	嫁出去的女兒潑出去的水
孝重千斤日减一斤	孝重千斤日減一斤
宁为鸡口不为牛后	寧爲雞口不爲牛後
宁为鸡口无为牛后	寧爲雞口無爲牛後
宁分数斗莫增一口	寧分數斗莫增一口
宁可折本休要饥损	寧可折本休要饑損
宁可无了有不可有了无	寧可無了有不可有了無
宁撞金钟一下不打破鼓三千	寧撞金鐘一下不打破鼓三千
安东尼与克莉奥佩特拉	安東尼與克莉奧佩特拉
安徽建筑工业学院	安徽建築工業學院
实践是检验真理的唯一标准	實踐是檢驗真理的唯一標準
家丑不可外传流言切莫轻信	家醜不可外傳流言切莫輕信
家有千口主事一人	家有千口主事一人
家有千贯不如日进分文	家有千貫不如日進分文
家有千金不如日进分文	家有千金不如日進分文
家有敝帚享之千金	家有敝帚享之千金
家累千金坐不垂堂	家累千金坐不垂堂
家鸡打的团团转野鸡打的贴天飞	家雞打的團團轉野雞打的貼天飛
密闭式循环再呼吸水肺系统	密閉式循環再呼吸水肺系統
寒武纪生命大爆发	寒武紀生命大爆發
寓管理于服务之中	寓管理于服務之中
察布查尔锡伯自治县	察布査爾錫伯自治縣
对外贸易经济合作部	對外貿易經濟合作部
寻甸回族彝族自治县	尋甸回族彝族自治縣
导弹武器技术控制制度	導彈武器技術控制制度
小时了了大未必佳	小時了了大未必佳
居民消费价格指数	居民消費價格指數
山中方七日世上已千年	山中方七日世上已千年
巍山彝族回族自治县	巍山彝族回族自治縣
工欲善其事必先利其器	工欲善其事必先利其器
巧妇做不得无面馎饦	巧婦做不得無麵餺飥
差之毫厘失之千里	差之毫釐失之千里
差之毫厘缪以千里	差之毫釐繆以千里
差之毫厘谬以千里	差之毫釐謬以千里
差以毫厘失之千里	差以毫釐失之千里
差以豪厘谬以千里	差以豪釐謬以千里
差若豪厘缪以千里	差若豪釐繆以千里
己所不欲勿施于人	己所不欲勿施於人
已所不欲勿施于人	已所不欲勿施於人
巴里坤哈萨克自治县	巴裏坤哈薩克自治縣
巴音郭愣蒙古自治州	巴音郭愣蒙古自治州
巴音郭楞蒙古自治州	巴音郭楞蒙古自治州
布鲁克海文国家实验室	布魯克海文國家實驗室
布鲁克海文实验室	布魯克海文實驗室
布鲁斯史普林斯汀	布魯斯史普林斯汀
师父领进门修行在个人	師父領進門修行在個人
平地上起一个霹雳	平地上起一個霹靂
平定准噶尔回部得胜图	平定準噶爾回部得勝圖
广东科学技术职业学院	廣東科學技術職業學院
庞毕度国家艺术文化中心	龐畢度國家藝術文化中心
建立正式外交关系	建立正式外交關係
开除党籍行政开除	開除黨籍行政開除
张家川回族自治县	張家川回族自治縣
弱水三千只取一瓢	弱水三千只取一瓢
弱水三千只取一瓢饮	弱水三千只取一瓢飲
强制汽车责任保险法	強制汽車責任保險法
当局称迷傍观必审	當局稱迷傍觀必審
当局者迷傍观者清	當局者迷傍觀者清
当局者迷旁观者清	當局者迷旁觀者清
当断不断反受其乱	當斷不斷反受其亂
得了些颜色就开起染房来	得了些顏色就開起染房來
得克萨斯州沃思堡电	得克薩斯州沃思堡電
得胜的猫儿欢似虎	得勝的貓兒歡似虎
得黄金百不如得季布诺	得黃金百不如得季布諾
得黄金百斤不如得季布一诺	得黃金百斤不如得季布一諾
德国学术交流总署	德國學術交流總署
德意志学术交流中心	德意志學術交流中心
德意志民主共和国	德意志民主共和國
德意志联邦共和国	德意志聯邦共和國
心头小鹿撞个不住	心頭小鹿撞個不住
怒从心上起恶向胆边生	怒從心上起惡向膽邊生
患难之交才是真正的朋友	患難之交纔是真正的朋友
愚者千虑必有一得	愚者千慮必有一得
戏法人人会变巧妙各有不同	戲法人人會變巧妙各有不同
成功的男人后面必有一个奉献的女人	成功的男人後面必有一個奉獻的女人
我们死后将会洪水滔天	我們死後將會洪水滔天
战无不胜攻无不克	戰無不勝攻無不克
战无不胜攻无不取	戰無不勝攻無不取
扁担压不出个屁来	扁擔壓不出個屁來
打狗也要看主人面	打狗也要看主人面
打翻了的牛奶而哭泣	打翻了的牛奶而哭泣
打蛇不死后患无穷	打蛇不死後患無窮
拜科努尔航天发射基地	拜科努爾航天發射基地
拿贼要赃拿奸要双	拿賊要贓拿姦要雙
振兴医疗复健中心	振興醫療復健中心
捉贼见赃捉奸见双	捉賊見贓捉姦見雙
捷克暨斯洛伐克联邦共和国	捷克暨斯洛伐克聯邦共和國
携带式卫星通信系统	攜帶式衛星通信系統
摇车儿里的爷爷拄拐棍儿的孙子	搖車兒裏的爺爺拄拐棍兒的孫子
攻其无备出其不意	攻其無備出其不意
攻无不克战无不胜	攻無不克戰無不勝
放了屁儿却使手掩	放了屁兒卻使手掩
政府机关开放系统互连总则	政府機關開放系統互連總則
救人一命胜造七级浮屠	救人一命勝造七級浮屠
数位快速篆刻系统	數位快速篆刻系統
数据链路连接识别码	數據鏈路連接識別碼
斯里兰卡民主社会主义共和国	斯里蘭卡民主社會主義共和國
新娘进了房媒人扔过墙	新娘進了房媒人扔過牆
旁观者审当局者迷	旁觀者審當局者迷
既有今日何必当初	既有今日何必當初
日出万言必有一伤	日出萬言必有一傷
日出而作日入而息	日出而作日入而息
早知今日何必当初	早知今日何必當初
早知今日悔不当初	早知今日悔不當初
早起的鸟儿有虫吃	早起的鳥兒有蟲吃
时代不同风尚不同	時代不同風尚不同
明修栈道暗渡陈仓	明修棧道暗渡陳倉
明志工业专科学校	明志工業專科學校
明是一盆火暗是一把刀	明是一盆火暗是一把刀
明枪好躲暗箭难防	明槍好躲暗箭難防
明枪易趓暗箭难防	明槍易趓暗箭難防
明枪易躲暗箭难防	明槍易躲暗箭難防
明潭抽蓄水力发电工程	明潭抽蓄水力發電工程
明知山有虎偏向虎山行	明知山有虎偏向虎山行
明知山有虎故作采樵人	明知山有虎故作採樵人
明者视于无形聪者听于无声	明者視於無形聰者聽於無聲
明鎗容易躲暗剑最难防	明鎗容易躲暗劍最難防
明鎗容易躲暗箭最难防	明鎗容易躲暗箭最難防
明鎗易躲暗箭难逃	明鎗易躲暗箭難逃
春生夏长秋收冬藏	春生夏長秋收冬藏
是罐子也有两个耳朵	是罐子也有兩個耳朵
晚娘的拳头云里的日头	晚娘的拳頭雲裏的日頭
普列谢茨克卫星发射场	普列謝茨克衛星發射場
景谷傣族彝族自治县	景谷傣族彝族自治縣
智慧型车辆暨公路系统	智慧型車輛暨公路系統
智者千虑必有一失	智者千慮必有一失
有一分心尽一分力	有一分心盡一分力
有个地洞钻了下去	有個地洞鑽了下去
有了存孝不显彦章	有了存孝不顯彥章
有借有还再借不难	有借有還再借不難
有冤报冤有仇报仇	有冤報冤有仇報仇
有意栽花花不发无心插柳柳成阴	有意栽花花不發無心插柳柳成陰
有福同享有祸同当	有福同享有禍同當
有福同享有难同当	有福同享有難同當
有缘千里来相会无缘对面不相逢	有緣千里來相會無緣對面不相逢
木垒哈萨克自治县	木壘哈薩克自治縣
杀人须见血救人须救彻	殺人須見血救人須救徹
杜尔伯特蒙古族自治县	杜爾伯特蒙古族自治縣
树高千丈落叶归根	樹高千丈落葉歸根
格林威治标准时间	格林威治標準時間
格林尼治标准时间	格林尼治標準時間
梁园虽好不是久恋之家	梁園雖好不是久戀之家
梅里亚姆韦伯斯特	梅里亞姆韋伯斯特
梅里斯达斡尔族区	梅里斯達斡爾族區
棋逢对手将遇良才	棋逢對手將遇良才
棺材出了讨挽歌郎钱	棺材出了討挽歌郎錢
横针不拈竖线不动	橫針不拈豎綫不動
欧洲安全与合作组织	歐洲安全與合作組織
欧洲安全和合作组织	歐洲安全和合作組織
欲人不知莫若勿为	欲人不知莫若勿爲
欲加之罪何患无词	慾加之罪何患無詞
欲加之罪何患无辞	欲加之罪何患無辭
欲善其事必先利其器	慾善其事必先利其器
正电子发射断层照相术	正電子發射斷層照相術
正电子发射计算机断层	正電子發射計算機斷層
正确处理人民内部矛盾	正確處理人民內部矛盾
死有重于泰山轻于鸿毛	死有重於泰山輕於鴻毛
死知府不如一个活老鼠	死知府不如一個活老鼠
每一个人都有美中不足的地方	每一個人都有美中不足的地方
比上不足比下有余	比上不足比下有餘
民和回族土族自治县	民和回族土族自治縣
民用航空器适航证书	民用航空器適航證書
氨基甲酸酯类化合物	氨基甲酸酯類化合物
水里水里来火里火里去	水裏水裏來火裏火裏去
沃枝叶不如培根本	沃枝葉不如培根本
没家亲引不出外鬼来	沒家親引不出外鬼來
没有长羽毛就忘了根本	沒有長羽毛就忘了根本
河南蒙古族自治县	河南蒙古族自治縣
河里淹死是会水的	河裏淹死是會水的
法兰克福证券交易所	法蘭克福證券交易所
法因于敝而成于过	法因於敝而成於過
波士顿艺术博物馆	波士頓藝術博物館
注意力缺陷过动症	注意力缺陷過動症
泰极还生否乐处又逢悲	泰極還生否樂處又逢悲
泰特斯安德洛尼克斯	泰特斯安德洛尼克斯
海峡两岸关系协会	海峽兩岸關係協會
海西蒙古族藏族自治州	海西蒙古族藏族自治州
液体燃料火箭发动机	液體燃料火箭發動機
清酒红人面财帛动人心	清酒紅人面財帛動人心
温布尔登网球公开赛	溫布爾登網球公開賽
满怀心腹事尽在不言中	滿懷心腹事盡在不言中
漏电保护接地极插座	漏電保護接地極插座
漫天要价就地还钱	漫天要價就地還錢
潘金莲给武松敬酒	潘金蓮給武松敬酒
濒危野生动植物种国际贸易公约	瀕危野生動植物種國際貿易公約
火箭喷射推进系统	火箭噴射推進系統
火里火去水里水去	火裏火去水裏水去
烟薰的佛像挂墙上	煙薰的佛像掛牆上
烽烟四起战火纷飞	烽煙四起戰火紛飛
熟读王叔和不如临症多	熟讀王叔和不如臨症多
燕雀安知鸿鹄之志	燕雀安知鴻鵠之志
燕雀焉知鸿鹄之志	燕雀焉知鴻鵠之志
爱丽丝漫游奇境记	愛麗絲漫遊奇境記
爱之欲其生恶之欲其死	愛之欲其生惡之欲其死
父母两系血统主义	父母兩系血統主義
牡丹虽好全仗绿叶扶	牡丹雖好全仗綠葉扶
牡丹虽好全仗绿叶扶持	牡丹雖好全仗綠葉扶持
牡丹虽好全凭绿叶扶持	牡丹雖好全憑綠葉扶持
牡丹虽好终须绿叶扶持	牡丹雖好終須綠葉扶持
狗口里吐不出象牙	狗口裏吐不出象牙
王婆卖瓜自卖自夸	王婆賣瓜自賣自誇
王子犯法与庶民同罪	王子犯法與庶民同罪
玩猫和老鼠的游戏	玩貓和老鼠的遊戲
环保与环境监控系统	環保與環境監控系統
生于优患死于安乐	生於優患死於安樂
生于忧患死于安乐	生於憂患死於安樂
生命不息战斗不止	生命不息戰鬥不止
生物技术与制药工业发展推动小组	生物技術與製藥工業發展推動小組
电机及电子学工程师联合会	電機及電子學工程師聯合會
电脑与电话系统整合	電腦與電話系統整合
男大当婚女大当嫁	男大當婚女大當嫁
病从口入祸从口出	病從口入禍從口出
白刀子进去红刀子出来	白刀子進去紅刀子出來
百万买宅千万买邻	百萬買宅千萬買鄰
百尺竿头更尽一步	百尺竿頭更盡一步
百足之虫死而不僵	百足之蟲死而不僵
百足之虫至死不僵	百足之蟲至死不僵
皇家加勒比海游轮公司	皇家加勒比海遊輪公司
盐打怎么咸醋打怎么酸	鹽打怎麼鹹醋打怎麼酸
相交满天下知心能几人	相交滿天下知心能幾人
瞒天讨价就地还钱	瞞天討價就地還錢
知无不言言无不尽	知無不言言無不盡
石油输出国家组织	石油輸出國家組織
礼轻人意重千里送鹅毛	禮輕人意重千里送鵝毛
福无重受日祸有并来时	福無重受日禍有並來時
秀才不出门能知天下事	秀才不出門能知天下事
秀才作医如菜作虀	秀才作醫如菜作虀
种上蒺藜就要扎脚	種上蒺藜就要扎腳
种火又长拄门又短	種火又長拄門又短
种瓜得瓜种豆得豆	種瓜得瓜種豆得豆
科学技术是第一生产力	科學技術是第一生產力
穷当益坚老当益壮	窮當益堅老當益壯
空军航空技术学院	空軍航空技術學院
穿鞋的不斗赤脚的	穿鞋的不鬥赤腳的
笔胜于刀文比武强	筆勝於刀文比武強
箭在弦上不得不发	箭在弦上不得不發
米罗的维纳斯雕像	米羅的維納斯雕像
紫云苗族布依族自治县	紫云苗族布依族自治縣
累积性伤害症候羣	累積性傷害症候羣
约翰˙克利斯多夫	約翰˙克利斯多夫
纽芬兰与拉布拉多	紐芬蘭與拉布拉多
线上即时交谈系统	綫上即時交談系統
线上电脑网路杂志	綫上電腦網路雜誌
经济协力开发机构	經濟協力開發機構
经济合作与发展组织	經濟合作與發展組織
经济合作开发组织	經濟合作開發組織
经济部标准检验局	經濟部標準檢驗局
经营决策资讯系统	經營決策資訊系統
综合服务数位网络	綜合服務數位網絡
网路连线型光碟柜	網路連綫型光碟櫃
罗培兹阿里格利亚	羅培茲阿里格利亞
罢黜百家独尊儒术	罷黜百家獨尊儒術
羊羣里跑出骆驼来	羊羣裏跑出駱駝來
美国国际开发总署	美國國際開發總署
美国资讯交换标准码	美國資訊交換標準碼
翻手为云覆手变雨	翻手爲雲覆手變雨
老猫鼻子上挂咸鱼	老貓鼻子上掛鹹魚
老王卖瓜自卖自夸	老王賣瓜自賣自誇
老米饭捏杀不成团	老米飯捏殺不成團
老虎生了翅膀一般	老虎生了翅膀一般
老骥伏枥志在千里	老驥伏櫪志在千里
老鼠拖木锨大头在后头	老鼠拖木杴大頭在後頭
老龟煮不烂移祸于枯桑	老龜煮不爛移禍於枯桑
耕当问奴织当访婢	耕當問奴織當訪婢
耳檐儿当不的胡帽	耳檐兒當不的胡帽
耶稣基督后期圣徒教会	耶穌基督後期聖徒敎會
联合包裹服务公司	聯合包裹服務公司
联合国儿童基金会	聯合國兒童基金會
联合国安全理事会	聯合國安全理事會
联合国开发计划署	聯合國開發計劃署
联合国敎科文组织	聯合國敎科文組織
联合国敎育科学文化组织	聯合國敎育科學文化組織
联合国教科文组织	聯合國敎科文組織
联合国气候变化框架公约	聯合國氣候變化框架公約
联合国海洋法公约	聯合國海洋法公約
联合国环境规划署	聯合國環境規劃署
联合国难民事务高级专员办事处	聯合國難民事務高級專員辦事處
联合核事故协调中心	聯合核事故協調中心
联合船舶设计发展中心	聯合船舶設計發展中心
聪明一世糊涂一时	聰明一世糊塗一時
肃北蒙古族自治县	肅北蒙古族自治縣
肉毒梭状芽孢杆菌	肉毒梭狀芽孢桿菌
肐膊只折在袖子里	肐膊只折在袖子裏
肐膊折了往袖子里藏	肐膊折了往袖子裏藏
肚里说不出来的苦	肚裏說不出來的苦
自动资料处理系统	自動資料處理系統
致理商业专科学校	致理商業專科學校
船不漏针漏针没外人	船不漏針漏針沒外人
船载的金银填不满烟花债	船載的金銀填不滿煙花債
良田万顷不如薄艺随身	良田萬頃不如薄藝隨身
良药苦口忠言逆耳	良藥苦口忠言逆耳
花无百日开人无千日好	花無百日開人無千日好
苏维埃社会主义共和国联盟	蘇維埃社會主義共和國聯盟
苏维埃社会主义共和国联邦	蘇維埃社會主義共和國聯邦
苏黎世联邦理工学院	蘇黎世聯邦理工學院
苦海无边回头是岸	苦海無邊回頭是岸
范德格拉夫起电机	範德格拉夫起電機
药医不死病佛度有缘人	藥醫不死病佛度有緣人
莫三比克人民共和国	莫三比克人民共和國
莫信直中直须防人不仁	莫信直中直須防人不仁
莫蹪于山而蹪于垤	莫蹪於山而蹪於垤
莫霍洛维奇不连续面	莫霍洛維奇不連續面
菲利克斯．米达麦亚	菲利克斯．米達麥亞
葫芦里卖的甚么药	葫蘆裏賣的甚麼藥
蒙一饭之恩尚杀身以报	蒙一飯之恩尚殺身以報
虚心使人进步骄傲使人落后	虛心使人進步驕傲使人落後
虾蟆跳在戥盘子里	蝦蟆跳在戥盤子裏
蚊子遭扇打只为嘴伤人	蚊子遭扇打只爲嘴傷人
蜂巢式行动电话系统	蜂巢式行動電話系統
蝨多了不咬债多了不愁	蝨多了不咬債多了不愁
螳螂捕蝉黄雀在后	螳螂捕蟬黃雀在後
蠹众而木折隙大而墙坏	蠹眾而木折隙大而牆壞
行万里路胜读万卷书	行萬裏路勝讀萬捲書
行万里路读万卷书	行萬里路讀萬卷書
行千里路读万卷书	行千裏路讀萬卷書
行政院研究发展考核委员会	行政院研究發展考核委員會
行百里者半于九十	行百里者半於九十
裘馨氏肌肉萎缩症	裘馨氏肌肉萎縮症
西藏百万农奴解放纪念日	西藏百萬農奴解放紀念日
要怎么收获先怎么栽	要怎麼收穫先怎麼栽
见之不取思之千里	見之不取思之千里
见物不取失之千里	見物不取失之千里
见钟不打更去炼铜	見鐘不打更去煉銅
说是一回事做又是另外一回事	說是一回事做又是另外一回事
说是一回事而做又是另外一回事	說是一回事而做又是另外一回事
读万卷书行万里路	讀萬卷書行萬里路
谁笑到最后谁笑得最好	誰笑到最後誰笑得最好
谁笑在最后谁笑得最好	誰笑在最後誰笑得最好
谷贵饿农谷贱伤农	穀貴餓農穀賤傷農
资讯通讯整合系统	資訊通訊整合系統
赤道几內亚共和国	赤道幾內亞共和國
走了和尚走不了庙	走了和尚走不了廟
跑了和尚跑不了寺	跑了和尚跑不了寺
跑了和尚跑不了庙	跑了和尚跑不了廟
跑得了和尚跑不了庙	跑得了和尚跑不了廟
路见不平也有向灯向火	路見不平也有向燈向火
踏小板凳儿糊险道神	踏小板凳兒糊險道神
躲一棒槌挨一榔头	躲一棒槌挨一榔頭
躲了雷公遇了霹雳	躲了雷公遇了霹靂
躲过了风暴又遇了雨	躲過了風暴又遇了雨
达尔罕茂明安联合旗	達爾罕茂明安聯合旗
过了这个村儿没这个店儿	過了這個村兒沒這個店兒
运用之妙在于一心	運用之妙在於一心
运筹帷幄之中决胜千里之外	運籌帷幄之中決勝千里之外
近乎同步数位阶层	近乎同步數位階層
近朱者赤近墨者黑	近朱者赤近墨者黑
远处夸称近方卖弄	遠處誇稱近方賣弄
远距图书服务系统	遠距圖書服務系統
送君千里终有一别	送君千里終有一別
送君千里终须一别	送君千里終須一別
通用汉字标准交换码	通用漢字標準交換碼
道格拉斯麦克阿瑟	道格拉斯麥克阿瑟
邮政储金转存制度	郵政儲金轉存制度
酒逢知己千锺少话不投机半句多	酒逢知己千鍾少話不投機半句多
释迦佛也恼下莲台	釋迦佛也惱下蓮臺
金乌西坠玉兔东升	金烏西墜玉兔東昇
金玉其表败絮其中	金玉其表敗絮其中
金钱不能买来幸福	金錢不能買來幸福
钟不扣不鸣鼓不打不响	鐘不扣不鳴鼓不打不響
钟在寺里声在外边	鐘在寺裏聲在外邊
钱不是万能的没钱是万万不能的	錢不是萬能的沒錢是萬萬不能的
铜山西崩洛钟东应	銅山西崩洛鐘東應
销售时点情报系统	銷售時點情報系統
镇宁布依族苗族自治县	鎮寧布依族苗族自治縣
长他人志气灭自己威风	長他人志氣滅自己威風
长江后浪催前浪一代新人换旧人	長江後浪催前浪一代新人換舊人
门背后放花子等不到晚	門背後放花子等不到晚
闭门家里坐祸从天上来	閉門家裏坐禍從天上來
阎王好见小鬼难当	閻王好見小鬼難當
阎罗王面前须没放回的鬼	閻羅王面前須沒放回的鬼
阜新蒙古族自治县	阜新蒙古族自治縣
防人之口甚于防川	防人之口甚於防川
防民之口甚于防川	防民之口甚於防川
阴离子界面活性剂	陰離子界面活性劑
阿克塞哈萨克族自治县	阿克塞哈薩克族自治縣
阿尔汉格尔斯克州	阿爾漢格爾斯克州
阿拉伯联合大公国	阿拉伯聯合大公國
阿拉伯联合酋长国	阿拉伯聯合酋長國
阿里巴巴与四十大盗	阿里巴巴與四十大盜
青出于蓝而胜于蓝	青出於藍而勝於藍
非对称式数据用户线	非對稱式數據用戶綫
靡不有初鲜克有终	靡不有初鮮克有終
面心立方最密堆积	面心立方最密堆積
鞠躬尽瘁死而后已	鞠躬盡瘁死而後已
项庄舞剑志在沛公	項莊舞劍志在沛公
顺德者吉逆天者凶	順德者吉逆天者凶
风在那里起雨在那里落	風在那裏起雨在那裏落
风险与收益的关系	風險與收益的關係
食品药品监督管理局	食品藥品監督管理局
食物及药品管理局	食物及藥品管理局
饥不可食寒不可衣	飢不可食寒不可衣
饭后百步走活到九十九	飯後百步走活到九十九
饭饱生馀事饥寒腹自安	飯飽生餘事飢寒腹自安
马来亚玻里尼西亚语系	馬來亞玻里尼西亞語系
骨头里挣出来的钱才做得肉	骨頭裏掙出來的錢纔做得肉
高雄科学技术学院	高雄科學技術學院
鲋鱼困涸辙难待西江水	鮒魚困涸轍難待西江水
鳖了一肚子的闷气	鱉了一肚子的悶氣
鹬蚌相争渔人获利	鷸蚌相爭漁人獲利
麻雀虽小五脏俱全	麻雀雖小五臟俱全
麾之即去招则须来	麾之即去招則須來
黄钟毁弃瓦釜雷鸣	黃鐘譭棄瓦釜雷鳴
黄鹰抓住了鹞子的脚	黃鷹抓住了鷂子的腳
黑头虫儿不可救救之就要吃人肉	黑頭蟲兒不可救救之就要吃人肉
黔南布依族苗族自治州	黔南布依族苗族自治州
黔西南布依族苗族自治州	黔西南布依族苗族自治州
鼓不打不响钟不撞不鸣	鼓不打不響鐘不撞不鳴
龙斗虎伤苦了小獐	龍鬥虎傷苦了小獐
